0A	0-a
0BrandingLengthComparator	0-branding-length-comparator
0L	0-l
0M	0-m
0P	0-p
0R	0-r
0ResetOperation	0-reset-operation
0Result	0-result
0SetAndNotify	0-set-and-notify
0StoredTokenStream	0-stored-token-stream
0UIOperation	0-ui-operation
0UIRunnable	0-ui-runnable
0UpdateTask	0-update-task
1FFS	1-ffs
1FakeNaming	1-fake-naming
1FutureTaskExtension	1-future-task-extension
1L	1-l
1Panel	1-panel
1R	1-r
1X	1-x
2X	2-x
3H	3-h
3S	3-s
3T	3-t
A	a
AA	aa
AAnnotation	a-annotation
AE	ae
AEProxyFactory	ae-proxy-factory
AEThread2	ae-thread-2
AIDPanel	aid-panel
APDUParser	apdu-parser
APIFreezeReportConversionTask	api-freeze-report-conversion-task
APTFindUnusedBlocksWalker	apt-find-unused-blocks-walker
APTHandlersSupportImpl	apt-handlers-support-impl
APTLanguageSupportImpl	apt-language-support-impl
ASItem	as-item
ASN1Null	asn1-null
ASTBasedAnnotationElementDeclarationImpl	ast-based-annotation-element-declaration-impl
ASTCompiler	ast-compiler
ASTFalse	ast-false
ASTIntConstNode	ast-int-const-node
ASTIntegerRange	ast-integer-range
ASTIsEmpty	ast-is-empty
ASTVarDeclaration	ast-var-declaration
AWTAutoShutdown	awt-auto-shutdown
AWTLockAccess	awt-lock-access
AZBadPiece	az-bad-piece
AZMyInstanceImpl	az-my-instance-impl
AboutFieldTableModel	about-field-table-model
AbstractActionRadioMenuItem	abstract-action-radio-menu-item
AbstractAdapterNode	abstract-adapter-node
AbstractAntEditorPreferencePage	abstract-ant-editor-preference-page
AbstractBreakpointOrganizerDelegate	abstract-breakpoint-organizer-delegate
AbstractCTypeInfoImpl	abstract-c-type-info-impl
AbstractCharArrayType	abstract-char-array-type
AbstractCollectionEvent	abstract-collection-event
AbstractCollectionPersister	abstract-collection-persister
AbstractContentMetadataMutatorAction	abstract-content-meta-data-mutator-action
AbstractCreateAnnotationHint	abstract-create-annotation-hint
AbstractDOMParser	abstract-dom-parser
AbstractDebugActionDelegate	abstract-debug-action-delegate
AbstractDecimalMaxValidator	abstract-decimal-max-validator
AbstractDeploymentModelBuilder	abstract-deployment-model-builder
AbstractDeploymentRepository	abstract-deployment-repository
AbstractDialog	abstract-dialog
AbstractDocument	abstract-document
AbstractDocumentModel	abstract-document-model
AbstractEncoder	abstract-encoder
AbstractExcelView	abstract-excel-view
AbstractExtensionInfo	abstract-extension-info
AbstractFieldValidatorDescription	abstract-field-validator-description
AbstractFilesListener	abstract-files-listener
AbstractFix	abstract-fix
AbstractFolder	abstract-folder
AbstractFormatLayer	abstract-format-layer
AbstractGuardedSectionsProvider	abstract-guarded-sections-provider
AbstractGxp	abstract-gxp
AbstractHttp11ConnectorGBean	abstract-http11-connector-g-bean
AbstractHttpServletRequestWrapper	abstract-http-servlet-request-wrapper
AbstractIndenter	abstract-indenter
AbstractItr	abstract-itr
AbstractJndiBinderDeployer	abstract-jndi-binder-deployer
AbstractMapEntry	abstract-map-entry
AbstractMethodCorrectionProposal	abstract-method-correction-proposal
AbstractPool	abstract-pool
AbstractProblemDetector	abstract-problem-detector
AbstractProcessor	abstract-processor
AbstractPublishTask	abstract-publish-task
AbstractPublisherAction	abstract-publisher-action
AbstractPublisherApplication	abstract-publisher-application
AbstractRefreshablePortletApplicationContext	abstract-refreshable-portlet-application-context
AbstractRemoveActionDelegate	abstract-remove-action-delegate
AbstractResultNode	abstract-result-node
AbstractScannableCodeBaseEntry	abstract-scannable-code-base-entry
AbstractServer	abstract-server
AbstractServletContextWrapper	abstract-servlet-context-wrapper
AbstractSizeValidator	abstract-size-validator
AbstractSlsbInvokerInterceptor	abstract-slsb-invoker-interceptor
AbstractSourceContainerBrowser	abstract-source-container-browser
AbstractSourceCreator	abstract-source-creator
AbstractSourceLookupDirector	abstract-source-lookup-director
AbstractStringList	abstract-string-list
AbstractSyntheticBinding	abstract-synthetic-binding
AbstractTableRendering	abstract-table-rendering
AbstractTask	abstract-task
AbstractTest	abstract-test
AbstractTopLevelController	abstract-top-level-controller
AbstractUIInputReceiver	abstract-ui-input-receiver
AbstractUrlConnectionOutgoingFileTransfer	abstract-url-connection-outgoing-file-transfer
AbstractWizardScreen	abstract-wizard-screen
AbstractXMLNavigatorContent	abstract-xml-navigator-content
AccController	acc-controller
AcceleratedImageCapabilities	accelerated-image-capabilities
AcceptItemCommandPresenter	accept-item-command-presenter
AcceptRefactoringsAction	accept-refactorings-action
AcceptorBwdFinder	acceptor-bwd-finder
AcceptorFactory	acceptor-factory
AccessError	access-error
AccessibleAWTMenu	accessible-awt-menu
AccessibleAWTMenuComponent	accessible-awt-menu-component
AccessibleActionAdapter	accessible-action-adapter
AccessibleJInternalFrame	accessible-j-internal-frame
AccumPerfData	accum-perf-data
AccumulativeRunnable	accumulative-runnable
AckRequestIntervalFactory	ack-request-interval-factory
ActionAddOFSState	action-add-ofs-state
ActionAddPackage	action-add-package
ActionAddSignalsToSignalEvent	action-add-signal-sto-signal-event
ActionContributionItem	action-contribution-item
ActionEdit	action-edit
ActionErrorModel	action-error-model
ActionGoToCritique	action-go-to-critique
ActionImportXMI	action-import-xmi
ActionMessage	action-message
ActionNavigateUpNextDown	action-navigate-up-next-down
ActionNewEntryCallAction	action-new-entry-call-action
ActionNewProfile	action-new-profile
ActionNewReception	action-new-reception
ActionNewSignalEvent	action-new-signal-event
ActionPropertyRefresh	action-property-refresh
ActionProviderImpl	action-provider-impl
ActionRemovePackageImport	action-remove-package-import
ActionRunnable	action-runnable
ActionSetAddAssociationEndMode	action-set-add-association-end-mode
ActionSetContext	action-set-context
ActionSetMultiplicity	action-set-multiplicity
ActionSetTagDefinitionType	action-set-tag-definition-type
ActivatedTCListener	activated-tc-listener
ActivationPropertyImpl	activation-property-impl
ActiveEdgeList	active-edge-list
ActiveMenuSection	active-menu-section
ActiveRequestResponseCacheValve	active-request-response-cache-valve
ActivityGraphsHelperMDRImpl	activity-graphs-helper-mdr-impl
ActivityManagerEvent	activity-manager-event
ActivityRequirementBinding	activity-requirement-binding
ActorClassRole	actor-class-role
AdaptableJobFactory	adaptable-job-factory
AdapterManager	adapter-manager
AdapterNonExistent	adapter-non-existent
AddAdvancedAction	addadvanced-action
AddAllPluginsToJavaSearchHandler	add-all-plugins-to-java-search-handler
AddBreakpointPanel	add-breakpoint-panel
AddCustomConstructorOperation	add-custom-constructor-operation
AddElementImportCommand	add-element-import-command
AddFormBeanPanel	add-form-bean-panel
AddImportComparator	add-import-comparator
AddImportCorrectionProposal	add-import-correction-proposal
AddLayerAction	add-layer-action
AddMemoryRenderingActionDelegate	add-memory-rendering-action-delegate
AddMissingJavadocTagProposal	add-missing-javadoc-tag-proposal
AddNewSuiteComponentAction	add-new-suite-component-action
AddSelectMethodCodeGenerator	add-select-method-code-generator
AddToVersionControlDialog	add-to-version-control-dialog
AddWebServiceDlg	add-web-service-dlg
AddressBreakpointType	address-breakpoint-type
AddressUndoItem	address-undo-item
AdminObjectWrapper	admin-object-wrapper
AdvancedDialog	advanced-dialog
AdviceKind	advice-kind
AggregateProgressHandle	aggregate-progress-handle
AggregateValidationStatus	aggregate-validation-status
Aj	aj
AjConstructorDeclaration	aj-constructor-declaration
AjaxFormLoop	ajax-form-loop
AjaxPreprocessingCallDecorator	ajax-preprocessing-call-decorator
AjaxTestAction	ajax-test-action
AlgorithmName	algorithm-name
AllFieldTypes	all-field-types
AllLanguageProvider	all-language-provider
AllMarkersView	all-markers-view
AllocPageOperation	alloc-page-operation
AllocateColor	allocate-color
AllocationMail	allocation-mail
AllowGrabFocus	allow-grab-focus
AlphaColorPipe	alpha-color-pipe
AlphaComparator	alpha-comparator
AlternativesImpl	alternatives-impl
AnalysisException	analysis-exception
AnalysisSolver	analysis-solver
AndArtifactFilter	and-artifact-filter
AndCondition	and-condition
AndNode	and-node
AnimationItem	animation-item
AnimationLayout	animation-layout
AnnotDoubleElementValue	annot-double-element-value
AnnotatedString	annotated-string
AnnotatedWebApp	annotated-web-app
AnnotationBindingProcessor	annotation-binding-processor
AnnotationChangeListener	annotation-change-listener
AnnotationDeproxy	annotation-deproxy
AnnotationElementDeclarationImpl	annotation-element-declaration-impl
AnnotationHandlerChainBuilder	annotation-handler-chain-builder
AnnotationPainter	annotation-painter
AnnotationTypeMapping	annotation-type-mapping
AnnotationValueEnumRule	annotation-value-enum-rule
AnnotationValueProvider	annotation-value-provider
AnnotationWriter	annotation-writer
AnnotationXWorkConverter	annotation-x-work-converter
AnnotationsHighlighting	annotations-highlighting
AnnounceCountItem	announce-count-item
AnonAccessBeforeSuperConstructorCall2	anon-access-before-super-constructor-call-2
AnonAccessBeforeSuperConstructorCall3	anon-access-before-super-constructor-call-3
AntBuilderTabGroup	ant-builder-tab-group
AntClasspathContentProvider	ant-classpath-content-provider
AntClasspathPage	ant-classpath-page
AntDefiningTaskNode	ant-defining-task-node
AntFilterStore	ant-filter-store
AntInputHandler	ant-input-handler
AntMainTab	ant-main-tab
AntTypeDefinition	ant-type-definition
AntViewActionMessages	ant-view-action-messages
AntViewContentProvider	ant-view-content-provider
AnyAttributeProxy	any-attribute-proxy
AnyIO	any-io
Anything	anything
ApiKeyAuthentication	api-key-authentication
ApiModelFactory	api-model-factory
ApiPackage	api-package
ApiToolProjectNature	api-tool-project-nature
ApiUsePatternTab	api-use-pattern-tab
ApiUseTabGroup	api-use-tab-group
App2Test1	app-2-test-1
AppChanges	app-changes
AppClientActionProvider	app-client-action-provider
AppClientMain	app-client-main
AppClientModuleController	app-client-module-controller
AppClientModuleNode	app-client-module-node
AppFrame_AboutBox	app-frame-about-box
AppearancePanel	appearance-panel
AppendColumnAction	append-colum-naction
AppenderTableModel	appender-table-model
AppletAudioClipFactory	applet-audio-clip-factory
AppletSupport	applet-support
AppletXmlAppletEntry	applet-xml-applet-entry
ApplicationDescriptor	application-descriptor
ApplicationFilterConfig	application-filter-config
ApplicationPathRenderer	application-path-renderer
ApplicationXmlWizardIterator	application-xml-wizard-iterator
ApplyXSLTProperties	apply-xslt-properties
ApptBox	appt-box
Apt6CompilationParticipant	apt6-compilation-participant
AptPreferencePage	apt-preference-page
AquaMetalTheme	aqua-metal-theme
Ar	ar
ArabicNormalizer	arabic-normalizer
ArcCanvas	arc-canvas
ArchiveProjectType	archive-project-type
ArgHandlerClassName	arg-handler-class-name
ArrayElementValue	array-element-value
ArrayFactory	array-factory
ArrayInit_c	array-init-c
ArrayKlassKlass	array-klass-klass
ArrayModule	array-module
ArrayType_c	array-type-c
ArtifactGraphEdge	artifact-graph-edge
AspectJAnnotations	aspect-j-annotations
AspectJPointcutAdvisor	aspect-j-point-cut-advisor
AssembleScriptGenerator	assemble-script-generator
AssembleServerCommand	assemble-server-command
AssertStmt1	assert-stmt-1
AssertStmt2	assert-stmt-2
AssertStmt3	assert-stmt-3
AssertStmt4	assert-stmt-4
AssertStmt5	assert-stmt-5
AssertStmt6	assert-stmt-6
AssertStmt9	assert-stmt-9
AssertionFileFailedError	assertion-file-failed-error
AssertionViolatedException	assertion-violated-exception
AssignBitXorExpression	assign-bit-xor-expression
AssignLayers	assign-layers
AssignXCoordinates	assign-x-coordinates
AssociationsNode	associations-node
AssociativeInfixExpressionFragment	associative-infix-expression-fragment
AssumptionsPrinter	assumptions-printer
AsymmetricCipherKeyPair	asymmetric-cipher-key-pair
AsyncAppender	async-appender
AsyncPrintTableRenderingAction	async-print-table-rendering-action
AsyncProviderCallbackImpl	async-provider-call-back-impl
At	at
AtomicIntegerFieldUpdater	atomic-integer-field-updater
AttachLinkJDialog	attach-link-j-dialog
AttachmentDeleteDialog	attachment-delete-dialog
AttachmentType	attachment-type
AtticLogListener	attic-log-listener
AttrTableModel	attr-table-model
AttrValuesCompletion	attr-values-completion
AttributeAdd	attribute-add
AttributeChangeNotification	attribute-change-notification
AttributeDiff	attribute-diff
AttributeExpansionBinding	attribute-expansion-binding
AttributeGenerator	attribute-generator
AttributeGroupReferenceImpl	attribute-group-reference-impl
AttributeLocalizer	attribute-localizer
AttributeToken	attribute-token
AttributedStringIterator	attributed-string-iterator
AudioClip	audio-clip
AudioStreamSequence	audio-stream-sequence
AugLoadDerived	aug-load-derived
AugStore	aug-store
AugmentingThis7A	augmenting-this-7a
AuthEventDispatcher	auth-event-dispatcher
AuthorLinker	author-linker
AxisSettings	axis-settings
AzURLStreamHandlerFactory	az-url-stream-handler-factory
AzureusRestarterFactory	azureus-restarter-factory
B	b
B1	b1
B2IMaxScan	b-2-i-max-scan
B9	b9
BB	bb
BCMethod	bc-method
BDecoder	b-decoder
BEDoubleFormatDef	be-double-format-def
BERNull	ber-null
BI	bi
BIDataLoaderBeanInfo	bi-data-loader-bean-info
BN	bn
BP	bp
BSHArrayInitializer	bsh-array-initializer
BTRawMessage	bt-raw-message
BackButtonClickListener	back-button-click-listener
BackgroundCleaner	background-cleaner
BackwardAction	backward-action
BadServerDefinition	bad-server-definition
BadServerDefinitionHelper	bad-server-definition-helper
BadServerDefinitionHolder	bad-server-definition-holder
BarChartFillFactory	bar-chart-fill-factory
BarbecueCompiler	barbecue-compiler
Base64Converter	base64-converter
Base64Decoder	base64-decoder
BaseCAHandler	base-ca-handler
BaseDataFileFactory	base-data-file-factory
BaseGeronimoContextConfig	base-geronimo-context-config
BaseImportWizardSecondPage	base-import-wizard-second-page
BasePDEScanner	base-pde-scanner
BasePreferencePage	base-preference-page
Basic128Sha256Impl	basic128-sha256-impl
Basic256Sha256Factory	basic256-sha256-factory
BasicArrowButton	basic-arrow-button
BasicBlockSym	basic-block-sym
BasicCheckBoxUI	basic-check-box-ui
BasicCommand	basic-command
BasicGetter	basic-getter
BasicHTML	basic-html
BasicLinePainter	basic-line-painter
BasicListenerManager	basic-listener-manager
BasicModelAdapter	basic-model-adapter
BasicPanelProvider	basic-panel-provider
BasicSearchCriteria	basic-search-criteria
BasisLibrary	basis-library
BatDataLoader	bat-data-loader
BcelAdvice	bcel-advice
BcelRenderer	bcel-renderer
BeanDefinitionResource	bean-definition-resource
BeanDefinitionValidationException	bean-definition-validation-exception
BeanDirective	bean-directive
BeanFactoryAspectInstanceFactory	bean-factory-aspect-instance-factory
BeanImplementsBI	bean-implements-bi
BeanInfoUtils	bean-info-utils
BeanNavigatorJavaSourceFactory	bean-navigator-java-source-factory
BeginExp	begin-exp
BehaviorFinder	behavior-finder
BehaviorImpl	behavior-impl
BestJREAvailableMessage	best-jre-available-message
BigEndianArrayIO	big-endian-array-io
BigTypesFormatter	big-types-formatter
BinaryForSourceQueryImpl	binary-for-source-query-impl
BindYellow	bind-yellow
BindingInitializer	binding-initializer
BindingKeyResolver	binding-key-resolver
BindingManagerEvent	binding-manager-event
BindingSet	binding-set
BitConstantNode	bit-constant-node
BitXorExpression	bit-xor-expression
BlackAndRedSpidersColorProfile	black-and-red-spiders-color-profile
BlindingParameters	blinding-parameters
BlobImageResource	blob-image-resource
Block	block
BlockAdapter	block-adapter
BlockArg18Node	block-arg18-node
BlockBindingFactory	block-binding-factory
BlockComment	block-comment
BlockCountItem	block-count-item
BlockFormattingPrefixSuffix	block-formatting-prefix-suffix
BlockIntermediate	block-intermediate
BlockedJobsDialog	blocked-jobs-dialog
BlockingQueue	blocking-queue
Blogs	blogs
BlueJRMIServer	blue-jrmi-server
BluejFileUrlHandler	bluej-file-url-handler
BodyUpdater	body-updater
BookmarkFolder	bookmark-folder
BookmarkablePageLink	bookmarkable-page-link
BookmarksPersistence	bookmarks-persistence
BooleanScorer2	boolean-scorer-2
BooleanSerializer	boolean-serializer
BooleanTextValue	boolean-text-value
BorderBodyContainer	border-body-container
BorlandDeploymentTool	borland-deployment-tool
BottomNavigationElement	bottom-navigation-element
BoundsFormatter	bounds-formatter
BoyerMooreSearchMatcher	boyer-moore-search-matcher
BraceCompletionDeleteAction	brace-completion-delete-action
BranchLabel	branch-label
BranchProperty	branch-property
BranchRow	branch-row
BranchStatement	branch-statement
BrandedFile	branded-file
BrandingEditorPanel	branding-editor-panel
BreadCrumbBar	bread-crumb-bar
BreadcrumbActionGroup	breadcrumb-action-group
BreakpointGroup	breakpoint-group
BreakpointToggleActionOnBreakpoint	breakpoint-toggle-action-on-breakpoint
BrokenStateUpdater	broken-state-updater
BrokenViewItemNode	broken-view-item-node
BrokeredConnection	brokered-connection
Browse	browse
BrowseNodeModel	browse-node-model
BrowserCommandsMenu	browser-commands-menu
BrowserIORequest	browser-io-request
BrowserManagerProcess	browser-manager-process
BrowserPanel	browser-panel
BshScriptEngine	bsh-script-engine
BufferFactoryWrapper	buffer-factory-wrapper
BufferProject	buffer-project
BufferedContent	buffered-content
BufferedContext	buffered-context
BufferedGZipOutputStream	buffered-gzip-output-stream
BufferedMaskFill	buffered-mask-fill
BufferedTableRow	buffered-table-row
BugInstancePackageComparator	bug-instance-package-comparator
BugtrackingController	bug-tracking-controller
BugzillaConfiguration	bugzilla-configuration
BuildAccessorImpl	build-accessor-impl
BuildBaseImpl	build-base-impl
BuildConfig	build-config
BuildJavaProjectAction	build-java-project-action
BuildNumber	build-number
BuildOutlineContentProvider	build-outline-content-provider
BuildPathBasePage	build-path-base-page
BuildSuccess	build-success
BuildTimeFeatureFactory	build-time-feature-factory
BuildTimeSite	build-time-site
BuilderNewWizard	builder-new-wizard
BuiltInEncodingAlgorithmState	builtin-encoding-algorithm-state
BundleDirContext	bundle-dir-context
ButtonActionNewGuard	button-action-new-guard
ButtonActionPropertyChangeListener	button-action-property-change-listener
ButtonImageProperty	button-image-property
ButtonKeyBinding	button-key-binding
Bx	bx
ByReference	by-reference
ByValueInvokerInterceptor	by-value-invoker-interceptor
BypassClassLoader	bypass-class-loader
ByteArrayAttachment	byte-array-attachment
ByteArrayHashMap	byte-array-hash-map
ByteArrayTransfer	byte-array-transfer
ByteBufferOutputStream	byte-buffer-output-stream
ByteGray	byte-gray
ByteToCharCp037	byte-to-char-cp037
ByteToCharCp273	byte-to-char-cp273
ByteToCharCp277	byte-to-char-cp277
ByteToCharCp278	byte-to-char-cp278
ByteToCharCp280	byte-to-char-cp280
ByteToCharCp284	byte-to-char-cp284
ByteToCharCp285	byte-to-char-cp285
ByteToCharCp297	byte-to-char-cp297
ByteToCharMacSymbol	byte-to-char-mac-symbol
BytecodeBipush	byte-code-bipush
BytecodeMultiANewArray	byte-code-multi-a-new-array
C	c
C3P0ConnectionProvider	c3p0-connection-provider
C6	c-6
C8	c-8
CASUpdater	cas-updater
CB	cb
CBadClass	c-bad-class
CC	cc
CCombo	c-combo
CDCPlatformConfigurator	cdc-platform-configurator
CDROutputStreamBase	cdr-output-stream-base
CDataObject	c-data-object
CF	cf
CFGDetector	cfg-detector
CGIClientException	cgi-client-exception
CI	ci
CL	cl
CLIArgumentsList	cli-arguments-list
CLIHandler	cli-handler
CLIODCConfigurationAccessorImpl	cli-odc-configuration-accessor-impl
CLSTurtle	cls-turtle
CLineError	c-line-error
CMRFieldNode	cmr-field-node
CMRMessage	cmr-message
CMTTransaction	cmt-transaction
CModifier	c-modifier
CNCompoundName	cn-compound-name
COFFSymbolImpl	coff-symbol-impl
CP	cp
CPFile	cp-file
CPUserLibraryElement	cp-user-library-element
CR	cr
CRUDSampleDbPersistenceVisual	crud-sample-db-persistence-visual
CSAbstractDetails	cs-abstract-details
CSSParser	css-parser
CSSSSLTransportConfig	css-ssl-transport-config
CSharpTarget	c-sharp-target
CSourceClass	c-source-class
CStringValueType	c-string-value-type
CT	ct
CTabFolder	c-tab-folder
CTypesModule	c-types-module
CUnitCodeGenerator	c-unit-code-generator
CUniverseAttr	c-universe-attr
CVSModelProviderAction	cvs-model-provider-action
CVSParticipant	cvs-participant
CVSWorkspaceRoot	cvs-workspace-root
CVUtil	cv-util
CacheDirProvider	cache-dir-provider
CacheFileManagerStatsImpl	cache-file-manager-stats-impl
CacheReference	cache-reference
CacheReportGenerator	cache-report-generator
CachedConnectionManagerReference	cached-connection-manager-reference
CachedMessageProducer	cached-message-producer
CachedResultJob	cached-result-job
CachedXPathFuncHereAPI	cached-x-path-func-here-api
CactifyActionDelegate	cactify-action-delegate
CactifyWarTask	cactify-war-task
CalcTestDescription	calc-test-description
CalculateUsesOperation	calculate-uses-operation
CalendarCatalog	calendar-catalog
CallDerived	call-derived
CallHierarchyFiltersActionGroup	call-hierarchy-filters-action-group
CallList	call-list
CallMethodMultiRule	call-method-multi-rule
CallbackImpl	callback-impl
CallbackInfo	callback-info
CallbackRequestor	callback-requestor
CallersCalleesVisualizer	callers-callees-visualizer
CancelAction	cancel-action
CanonicalFilePathMap	canonical-file-path-map
Canonicalizer	canonicalizer
Canonicalizer20010315OmitComments	canonicalizer-20010315-omit-comments
CanonicalizerSpi	canonicalizer-spi
CanvasCD	canvas-cd
CanvasMapper	canvas-mapper
CaretAwareCsmFileTaskFactory	caret-aware-csm-file-task-factory
CastableAs	castable-as
CasualDiff	casual-diff
CatchBlockNormalizer	catch-block-normalizer
Categories	categories
CategoryButton	category-button
CategoryChildren	category-children
CategoryItemEntity	category-item-entity
CategoryOutlinePage	category-outline-page
CategoryPlot	category-plot
CciOperationNotSupportedException	cci-operation-not-supported-exception
CertPathHelperImpl	cert-path-helper-impl
CertificateImportConfirmationPage	certificate-import-confirmation-page
Ch	ch
ChainLambdas	chain-lambdas
ChangeMethodSignatureArguments	change-method-signature-arguments
ChangeMethodSignatureRefactoringContribution	change-method-signature-refactoring-contribution
ChangePreviewViewerDescriptor	change-preview-viewer-descriptor
ChangeToParentDirectoryAction	change-to-parent-directory-action
ChangeTypeRefactoring	change-type-refactoring
ChangedEvent	changed-event
ChannelSocket	channel-socket
CharArrayWriter	char-array-writer
CharChunk	char-chunk
CharToByteCp949C	char-to-byte-cp949c
CharToByteHKSCS	char-to-byte-hkscs
CharToByteUnicodeLittleUnmarked	char-to-byte-unicode-little-unmarked
CharacterClass	character-class
CharacterEditor	character-editor
CharacterEncodingFilter	character-encoding-filter
Character_CustomFieldSerializer	character-customfield-serializer
ChartOptionGroup	chart-option-group
ChatServiceImpl	chat-service-impl
CheckBoxMenuItemDefault	check-box-menu-item-default
CheckBoxMultipleChoicePage	check-box-multiple-choice-page
CheckBoxUpdater	check-box-updater
CheckConditionsOperation	check-conditions-operation
CheckConstraintDescriptor	check-constraint-descriptor
CheckHelpSetsBin	check-help-sets-bin
CheckMessages	check-messages
CheckVisitor	check-visitor
CheckboxMenuItemV2	check-box-menu-item-v2
CheckboxTreeViewer	check-box-tree-viewer
CheckboxesTag	check-boxes-tag
CheckedIterator	checked-iterator
CheckoutAsAction	checkout-as-action
ChessMove	chess-move
ChildBeanDefinition	child-bean-definition
ChineseAnalyzer	chinese-analyzer
ChooseBeansWizardPanel	choose-beans-wizard-panel
ChooseWorkspaceData	choose-workspace-data
ChopFrame	chop-frame
ChromeURLConnection	chrome-url-connection
CircleEvent	circle-event
CityMap	city-map
ClassBeanInfoImpl	class-bean-info-impl
ClassFileComparator	class-file-comparator
ClassFileMatchLocator	class-file-match-locator
ClassFileResourceMapping	class-file-resource-mapping
ClassFilter	class-filter
ClassImpl	class-impl
ClassItem	class-item
ClassLoaderAnnotationObjectOutputStream	class-loader-annotation-object-output-stream
ClassLoaderInterfaceDelegate	class-loader-interface-delegate
ClassManagerImpl	class-manager-impl
ClassNameBean	class-name-bean
ClassNameBeanWiringInfoResolver	class-name-bean-wiring-info-resolver
ClassNamesTable	class-names-table
ClassPathXmlApplicationContext	class-path-xml-application-context
ClassRepository	class-repository
ClassSignatureReader	class-signature-reader
ClassVertex	class-vertex
ClassWithMultipleSignaturesWithPrimitiveArgs	class-with-multiple-signatures-with-primitive-args
ClassesCountsViewAction	classes-counts-view-action
ClassesListTableKeyListener	classes-list-table-key-listener
ClassicGroovyTestGeneratorHelper	classic-groovy-test-generator-helper
ClasspathGroup	classpath-group
CleanUpChange	clean-up-change
CleanUpOptions	clean-up-options
Cleaner	cleaner
CleanupcopyAction	cleanup-copy-action
ClearDocumentBookmarks	clear-document-bookmarks
ClearPluginSet	clear-plugin-set
ClientDataLoader	client-data-loader
ClientDataSinkImpl	client-data-sink-impl
ClientJavaEEComponent	client-java-ee-component
ClipboardCopier	clipboard-copier
ClipboardTransfer	clipboard-transfer
Clone1	clone-1
ClonedComboBoxModel	cloned-combo-box-model
ClonedFilter	cloned-filter
Cloner	cloner
CloseFilterInputStream	close-filter-input-stream
CloseReaderTask	close-reader-task
ClosureCollectionSum	closure-collection-sum
ClosureException	closure-exception
CloudAdapter	cloud-adapter
ClusteredConcurrentTimestampsRegionImpl	clustered-concurrent-timestamps-region-impl
ClusteredSessionHandler	clustered-session-handler
ClusteredSessionManager	clustered-session-manager
ClusterizeInfo	clusterize-info
CmpFieldHelper	cmp-field-helper
CndFormat	cnd-format
CodeAnalyzer	code-analyzer
CodeSetComponentInfo	code-set-component-info
CodeSnippetToCuMapper	code-snippet-to-cu-mapper
CodeTemplateManagerOperation	code-template-manager-operation
CodecFactoryHelper	codec-factory-helper
CofferExtFactory_c	coffer-ext-factory-c
CofferMethodDecl_c	coffer-method-decl-c
CollapsedView	collapsed-view
CollatorUtilities	collator-utilities
CollectionGridDataSource	collection-grid-data-source
Collection_CustomFieldSerializerBase	collection-custom-field-serializer-base
ColorCustomEditorOperator	color-custom-editor-operator
ColorFilter	color-filter
ColoringAccessor	coloring-accessor
ColumnPresentationAdapterFactory	column-presentation-adapter-factory
ColumnSelectionPanel	column-selection-panel
ColumnViewerEditorDeactivationEvent	column-viewer-editor-deactivation-event
ComboBoxEditor	combo-box-editor
ComboNavigable	combo-navigable
ComboProperty	combo-property
ComboSelector	combo-selector
ComboViewerPart	combo-viewer-part
CommandLineException	command-line-exception
CommandLineExportApplication	command-line-export-application
CommandNotMappedException	command-not-mapped-exception
CommentCache	comment-cache
CommentCorrecterTask	comment-correcter-task
CommentIconItem	comment-icon-item
CommentRegion	comment-region
CommentsArea	comments-area
CommitIndexTask	commit-index-task
CommonFilterDescriptor	common-filter-descriptor
CommonHiddenStreamToken	common-hidden-stream-token
CommonMatchingTask	common-matching-task
CommonServerUIs	common-server-uis
CommonsHttpInvokerRequestExecutor	commons-http-invoker-request-executor
CompCSAddGroupAction	comp-cs-add-group-action
CompanyLogoListCellRenderer	company-logo-list-cell-renderer
CompareMessages	compare-messages
CompareWithEditionAction	compare-with-edition-action
CompilationUnitDelta	compilation-unit-delta
CompileAction	compile-action
CompileListenerForwarder	compile-listener-forwarder
CompileNamedPart	compile-named-part
CompileSelectedAction	compile-selected-action
CompileServerOptionsImpl	compile-server-options-impl
CompiledPieDataset	compiled-pie-data-set
CompilerAdapterFactory	compiler-adapter-factory
CompilerMessages	compiler-messages
CompilerSetAction	compiler-set-action
CompletionContextImpl	completion-context-impl
CompletionProposalComputerDescriptor	completion-proposal-computer-descriptor
ComponentDocument	component-document
ComponentInstanceResultProcessor	component-instance-result-processor
ComponentItem	component-item
ComponentPageElementImpl	component-page-element-impl
ComponentPageElementResourcesSourceImpl	component-page-element-resources-source-impl
ComponentPaletteOperator	component-palette-operator
ComponentTitledBorder	component-titled-border
CompositeBuilderViaSetters	composite-builder-via-setters
CompositeCPUCCTWalker	composite-cpucct-walker
CompositeComponentObject	composite-component-object
CompositeDebugImageDescriptor	composite-debug-image-descriptor
CompositeNode	composite-node
CompositionAreaHandler	composition-area-handler
CompoundContextProvider	compound-context-provider
CompoundLookupList	compound-lookup-list
CompressSpacePageOperation10_2	compress-space-pageo-peration-10-2
CompressedLineNumberReadStream	compressed-line-number-read-stream
ComputedList	computed-list
ConcatenatedIterator	concatenated-iterator
ConceptAnnotationsCustodian	concept-annotations-custodian
ConceptAttachmentsJPanel	concept-attachments-j-panel
ConcurrencyFailureException	concurrency-failure-exception
ConcurrentQueryStatisticsImpl	concurrent-query-statistics-impl
Condition	condition
ConditionalListSelectionDialog	conditional-list-selection-dialog
Conditions	conditions
ConfFilesNodeList	conf-files-node-list
ConfigFileMouseAdapter	config-file-mouse-adapter
ConfigGroupSelectionTableModel	config-group-selection-table-model
ConfigPanelListener	config-panel-listener
ConfigSectionStats	config-section-stats
ConfigurationClassEnhancer	configuration-class-enhancer
ConfigurationModel	configuration-model
ConfigurationParser	configuration-parser
ConfigurationPreview	configuration-preview
ConfigurationSupport	configuration-support
ConnectionEventListener	connection-event-listener
ConnectionHolder	connection-holder
ConnectionPanel	connection-panel
ConnectionPoolReader	connection-pool-reader
ConnectionValidator	connection-validator
ConsoleIntegerFieldEditor	console-integer-field-editor
ConsoleResponse	console-response
ConsoleTextField	console-text-field
ConstFold	const-fold
ConstantNode	constant-node
ConstantUtf8	constant-utf8
ConstantsInterfaceCreator	constants-interface-creator
ConstraintCollector	constraint-collector
ConstraintGraph	constraint-graph
ConstructorPanel	constructor-panel
ConstructorResolver	constructor-resolver
Consumer	consumer
ConsumerWriter	consumer-writer
ContactsDatabase	contacts-database
Container	container
ContainerComparator	container-comparator
ContainerDependencyItem	container-dependency-item
ContainerSelectionGroup	container-selection-group
ContainerVisitor	container-visitor
ContentChangeNotifier	content-change-notifier
ContentTypeDecorator	content-type-decorator
ContentTypesContentProvider	content-types-content-provider
ContextBasedFormattingStrategy	context-based-formatting-strategy
ContextEditExample	context-edit-example
ContextInformationPopup2	context-information-popup-2
ContextNamespaceHandler	context-namespace-handler
ContextParamMergeHandler	context-param-merge-handler
ContextPermissions	context-permissions
ContribIntervals	contrib-intervals
ContributionTemplateMessages	contribution-template-messages
ControlDecorationUpdater	control-decoration-updater
ControlLocationProperty	control-location-property
ControlModel	control-model
Conversions	conversions
ConvertLineDelimitersToMacOS9	convert-line-delimiters-to-mac-os9
ConvertTypeFix	convert-type-fix
ConvertVisitor	convert-visitor
ConverterFactoryAdapter	converter-factory-adapter
ConverterItem	converter-item
ConverterServlet	converter-servlet
Cookie	cookie
CookieFactoryImpl	cookie-factory-impl
CookiePathComparator	cookie-path-comparator
CopiesList	copies-list
CopyInfo	copy-info
CopyItemAction	copy-item-action
CopyMenuItem	copy-menu-item
CopyResourcesOperation	copy-resources-operation
CopyRowsOperation	copy-rows-operation
CopySourceInfo	copy-source-info
CopyToClipboardEnablementPolicy	copy-to-clipboard-enablement-policy
CoreHelperMDRImpl	core-helper-mdri-mpl
CoreListener	core-listener
CoreReaders	core-readers
CorextMessages	corext-messages
CostRateTableFactory	cost-rate-table-factory
CountByPackagePrefix	count-by-package-prefix
CounterService	counter-service
CounterTest	counter-test
CpoolString	cpool-string
CrJoinIncomingTransition	cr-join-incoming-transition
CrUtilityViolated	cr-utility-violated
CreateAction	create-action
CreateBundleOption	create-bundle-option
CreateContainerJob	create-container-job
CreateFile	create-file
CreatePersistenceUnit	create-persistence-unit
CreateStepFilterDialog	create-step-filter-dialog
CreateTableConstantAction	create-table-constant-action
CreateTypeOperation	create-type-operation
CreateXMLPane	create-xml-pane
CreatedProjectInfo	created-project-info
Credential	credential
CredentialManager	credential-manager
CreditCardValidator	credit-card-validator
CriteriaDefinitionFileParser	criteria-definition-file-parser
Critic	critic
CrossPlatformExportPage	cross-platform-export-page
CrossSiteIframeLinker	cross-site-iframe-linker
CrosscuttingMembersSet	cross-cutting-members-set
CsmIncludeHyperlinkProvider	csm-include-hyperlink-provider
CsmIncludeResolver	csm-include-resolver
CsmPaintComponent	csm-paint-component
CsmPaintComponentWrapper	csm-paint-component-wrapper
CssLanguage	css-language
CssPreviewPanel	css-preview-panel
CssTemplate	css-template
CssValue	css-value
CtxHelpBlock	ctx-help-block
Current	current
CurrentCall	current-call
CurrentFrameChangedEvent	current-frame-change-devent
CurrentTaskChangeEvent	current-task-change-event
CustomBuilderGenerator	custom-builder-generator
CustomCompositeInvocationHandlerImpl	custom-composite-invocation-handler-impl
CustomInstallValidator	custom-install-validator
CustomTableModelEditor	custom-table-model-editor
CustomerController	customer-controller
CustomerResource	customer-resource
CustomizableThreadCreator	customizable-thread-creator
CustomizeActionBars	customize-action-bars
CustomizerLibrariesFactory	customizer-libraries-factory
CustomizerPackagingFactory	customizer-packaging-factory
CustomizerProviderImpl	customizer-provider-impl
CustomizerWSServiceHost	customizer-ws-service-host
CutEndOfWordAction	cut-end-of-word-action
CvsAnnotation	cvs-annotation
CwBidiFormatting	cw-bidi-formatting
CwMessagesExample	cw-messages-example
D	d
D3DTextureToSurfaceTransform	d3d-texture-to-surface-transform
D5	d-5
D6	d-6
D8	d-8
DASTORE	dastore
DBColumn	db-column
DC	dc
DDLSingleTableConstantAction	ddl-single-table-constant-action
DETECTION_STRATEGY	detection-strategy
DG	dg
DH	dh
DHPrivateKeySpec	dh-private-key-spec
DHTFactory	dht-factory
DHTTransportRequestCounter	dht-transport-request-counter
DHTTransportUDPContactImpl	dht-transport-udp-contact-impl
DHTUDPPacketNetworkHandler	dht-udp-packet-network-handler
DHTUDPPacketRequestFindNode	dht-udp-packet-request-find-node
DL	dl
DLightSessionAccessor	d-light-session-accessor
DLightSessionAccessorImpl	d-light-session-accessor-impl
DLightSessionHandler	d-light-session-handler
DLightToolUIWrapper	d-light-tool-ui-wrapper
DO	do
DOM2TO	dom-2-to
DOMFinder	dom-finder
DOMImplIE6	dom-impl-ie6
DOMImplIE8	dom-impl-ie8
DOMKeyInfo	dom-key-info
DOMSignatureValue	dom-signatur-evalue
DPMWrapper	dpm-wrapper
DSAKeyGenerationParameters	dsa-key-generation-parameters
DTDIndentEngineBeanInfo	dtd-indent-engine-bean-info
DTMNodeListBase	dtm-node-list-base
DalpParserHandlerImpl	dalp-parser-handler-impl
DataAccessUtils	data-access-utils
DataBufferNative	data-buffer-native
DataCollectorFactory	data-collector-factory
DataDisplay	data-display
DataListener	data-listener
DataSourceReferencePanel	data-source-reference-panel
DataState	data-state
DataTablePage	data-table-page
DataTypesFactoryEUMLImpl	data-types-factory-euml-impl
DatabaseCommand	database-command
DatabaseDefinition	database-definition
DatabasePropertyTestSetup	database-property-test-setup
DatagramStringWriter	datagram-string-writer
DatatypeFactoryImpl	data-type-factory-impl
DateFeedItemComparator	date-feed-item-comparator
DateFormatSymbols	date-format-symbols
DateGroovyMethods	date-groovy-methods
DatePickerCell	date-picker-cell
DateRendererAdapter	date-renderer-adapter
DateTickUnit	date-tick-unit
DateTimeFormatCreator	date-time-format-creator
DateTimeFormatInfoImpl_oc	date-time-format-info-impl-oc
DateTimeFormatInfoImpl_om	date-time-format-info-impl-om
Db	db
DbIndexInput	db-index-input
DbSchemaEntityMember	db-schema-entity-member
DeactivateCategoryAction	deactivate-category-action
DeadCodeEliminator	dead-code-eliminator
DeadCodeVisitor	dead-code-visitor
DebugEnabledCheckboxHelper	debug-enabled-check-box-helper
DebugInfo	debug-info
DebugServer	debug-server
DebugTestAction	debug-test-action
DebugVC50SubsectionImpl	debug-vc50-subsection-impl
DebuggerManagerListener	debugger-manager-listener
DebuggerThread	debugger-thread
DecayCodeCompletionDataStructuresThread	decay-code-completion-data-structures-thread
DeclarationOfAccessedFieldsPattern	declaration-of-accessed-fields-pattern
DeclarationUID	declaration-uid
DecoratorButton	decorator-button
DefaultAWTBridge	default-awt-bridge
DefaultAbstractTree	default-abstract-tree
DefaultAnimationFeedback	defaul-tanimation-feedback
DefaultAsmTypesEntry	default-asm-types-entry
DefaultContourDataset	default-contour-dataset
DefaultCurrencyData	default-currency-data
DefaultEditor	default-editor
DefaultEvaluator	default-evaluator
DefaultFactory	default-factory
DefaultFlushEventListener	default-flush-event-listener
DefaultHandler2	default-handler-2
DefaultInformationControlCreator	default-information-control-creator
DefaultJavaPlatformProvider	default-java-platform-provider
DefaultLocator	default-locator
DefaultMarkupCacheKeyProvider	default-markup-cache-key-provider
DefaultObjectVisitor	default-object-visitor
DefaultOnDemandContextIntegrator	default-on-demand-context-integrator
DefaultProgressMeteringPolicy	default-progress-metering-policy
DefaultRequestExceptionHandler	default-request-exception-handler
DefaultRule_guw	default-rule-guw
DefaultServletConfiguration	default-servlet-configuration
DefaultSingleSelectionModel	default-single-selection-model
DefaultState	default-state
DefaultSynchronizationPolicy	default-synchronization-policy
DefaultTabDataModel	default-tab-data-model
DefaultTopComponentGroupModel	default-top-component-group-model
DefaultTransmitTextFilePreprocessor	default-transmit-text-file-preprocessor
DefaultTreeFeatures	default-tree-features
DefaultTypeTransformation	default-type-transformation
DefaultValidatorFileParser	default-validator-file-parser
DefaultValueProvider	default-value-provider
DefaultWorkingCopyOwner	default-working-copy-owner
DefaultXMLProcessorDetail	default-xml-processor-detail
DeferredMethodWrapper	deferred-method-wrapper
DefinedFilterSetsListSelectionListener	defined-filter-sets-list-selection-listener
DefinitelyNullSetAnalysis	definitely-null-set-analysis
DefinitionsBindingsImpl	definitions-bindings-impl
DeindentBlockAction	deindent-block-action
DelayedEvent	delayed-event
DelayedNodeIterator	delayed-node-iterator
DelegateLoader	delegate-loader
DelegateTaskDialog	delegate-task-dialog
DelegatedScheduledExecutorService	delegated-scheduled-executor-service
DelegatedSymbol	delegated-symbol
DelegatingChangeListenerCollection	delegating-change-listener-collection
DelegatingFocusListenerCollection	delegating-focus-listener-collection
DelegatingTreeModel	delegating-tree-model
DelegatingValidatorContext	delegating-validator-context
DelegationPerm	delegation-perm
DeleteModifications	delete-modifications
DeletePrevCharAction	delete-prev-char-action
DeleteResourceAction	delete-resource-action
DeltaPackScriptGenerator	delta-pack-script-generator
DependenciesPanel	dependencies-panel
DependenciesViewComparator	dependencies-view-comparator
DependencyFormat	dependency-format
DependencyListModel	dependency-list-model
DependencyPropertiesDialog	dependency-properties-dialog
DeployCacheJarAccessImpl	deploy-cache-jar-access-impl
DeployOnSaveManager	deploy-on-save-manager
DeployerConfig	deployer-config
DeploymentHelper	deployment-helper
DeprecatedFilter	deprecated-filter
DescriptionImpl	description-impl
DeselectAllAction	deselect-all-action
DetailType	detail-type
DetailsAction	details-action
DevNullProgressMonitor	dev-null-progress-monitor
DevPollArrayWrapper	dev-poll-array-wrapper
DevUtilsPage	dev-utils-page
DevanagariInputMethodDescriptor	devanagari-input-method-descriptor
DeviceTivoManager	device-tivo-manager
DiagnosticFormatter	diagnostic-formatter
DiagramScene	diagram-scene
DiagramSettings	diagram-settings
DialogField	dialog-field
DictDerived	dict-derived
DiffContentPanel	diff-content-panel
DiffProjectResourceMapping	diff-project-resource-mapping
DifferencesIterator	differences-iterator
DirectByteBufferPoolReal	direct-byte-buffer-pool-real
DirectiveQuery	directive-query
DirectoriesJPanel	directories-j-panel
DirectoryAsFileException	directory-as-file-exception
DirectoryChangeListener	directory-change-listener
DirectoryClassPathEntry	directory-class-path-entry
DirectoryDeployment	directory-deployment
DirectoryMonitor	directory-monitor
DirectoryNode	directory-node
DisableStreamingSecurityImpl	disable-streaming-security-impl
DisabledEditorPanel	disabled-editor-panel
DisabledWhenSortedAction	disabled-when-sorted-action
DiscoveredCodeBase	discovered-code-base
DiscoveryConfigurator	discovery-configurator
DiskRepositoryManager	disk-repository-manager
DiskStatus	disk-status
DismantleBytecode	dismantle-byte-code
DispatchActionSupport	dispatch-action-support
DispatchMessages	dispatch-messages
DisplayMessages	display-messages
DisplayabilityListener	displayability-listener
DistJarExecValue	dist-jar-exec-value
DistillerRebindPermutationOracle	distiller-rebind-permutation-oracle
DistributedPOJOState	distributed-pojo-state
DistributedStateSynchronization	distributed-state-synchronization
DistributionManagementImpl	distribution-management-impl
Dn	dn
DnDTreeSelectionListener	dnd-tree-selection-listener
DnameParam	dname-param
DoNotShowDialogDescriptor	do-not-show-dialog-descriptor
DocFieldConsumerPerField	doc-field-consumer-per-field
DocFieldConsumerPerThread	doc-field-consumer-per-thread
DocFieldConsumersPerField	doc-field-consumers-per-field
DocPositions	doc-positions
DocletAbortException	doclet-abort-exception
DocletInvoker	doclet-invoker
DocumentCache	document-cache
DocumentController	document-controller
DocumentManager	document-manager
DocumentModelAccess	document-model-access
DocumentOptions	document-options
DocumentRewriteSessionType	document-rewrite-session-type
DocxTableHelper	docx-table-helper
DomainEnumeration	domain-enumeration
DoubleConstant	double-constant
DoubleInteger	double-integer
DownloadPropertyNotifier	download-property-notifier
DownloadWillBeRemovedNotifier	download-will-be-removed-notifier
DrawDependencyInteraction	draw-dependency-interaction
DrawParallelogram	draw-parallelogram
DrillDownPanel	drill-down-panel
Driver20	driver-20
Driver30	driver-30
Driver40	driver-40
DropConstraintConstantAction	drop-constraint-constant-action
DtraceParser	dtrace-parser
DummyLockManager	dummy-lock-manager
DummyRenderer	dummy-renderer
DwarfAbbriviationTable	dwarf-abbriviation-table
DwarfSource	dwarf-source
DynaTable	dyna-table
DynamicCredsPanel	dynamic-creds-panel
DynamicHelpAction	dynamic-help-action
DynamicLibrary	dynamic-library
DynamicMapEntityTuplizer	dynamic-map-entity-tuplizer
DynamicMapInstantiator	dynamic-map-instantiator
DynamicMenuItem	dynamic-menu-item
DynamicProxyManager	dynamic-proxy-manager
E	e
EC	ec
ED	ed
EE	ee
EEVMPage	eevm-page
EH	eh
EJB3FlushEventListener	ejb3-flush-event-listener
EJBRulesRegistry	ejb-rules-registry
EJBTimerServiceImpl	ejb-timer-service-impl
EM	em
EMProperty	em-property
ENCLoader	enc-loader
EP	ep
ER	er
ET	et
ETRCallback	etr-callback
ETableColumnComparator	e-table-column-comparator
EToolkit	e-tool-kit
EUC_CN	euc-cn
EUC_JP	euc-jp
EUC_KR	euc-kr
EchoThread	echo-thread
EclipseFileManager	eclipse-file-manager
EclipseLauncherTabGroup	eclipse-launcher-tab-group
Ed	ed
EditActionGroup	edit-action-group
EditKeystoreHandler	edit-key-store-handler
EditLongAction	edit-long-action
EditRegionsImpl	edit-regions-impl
EditableListModel	editable-list-model
EditingSupport	editing-support
EditorActionsProvider	editor-actions-provider
EditorData	editor-data
EditorElement	editor-element
EditorOperator	editor-operator
EffectGetterSetter	effect-getter-setter
EhCacheProvider	eh-cache-provider
Ejb3EntityNotFoundDelegate	ejb3-entity-not-found-delegate
EjbContainer	ejb-container
EjbDaemonGBean	ejb-daemon-g-bean
EjbDeploymentGBean	ejb-deployment-g-bean
EjbJarImpl2	ejb-jar-impl-2
EjbLocalRefsEngine	ejb-local-refs-engine
EjbMetadataReader	ejb-metadata-reader
EjbModuleJSR77Deployer	ejb-module-jsr77-deployer
EjbRefHelper	ejb-ref-helper
ElFunctions	el-functions
ElGamalParameters	el-gamal-parameters
ElemExtensionCall	elem-extension-call
ElementCompareRequest	element-compare-request
ElementInfo	element-info
ElementMapperImpl	element-mapper-impl
ElementOutline	element-outline
ElementSpec	element-spec
ElementTreeModel	element-tree-model
ElfPanel	elf-panel
EmbedResultSetMetaData	embed-result-set-meta-data
EmptyAssociation	empty-association
EmptyChecker	empty-checker
EmptyDirectoryCondition	empty-directory-condition
EmptyFilter	empty-filter
EmptyList_CustomFieldSerializer	empty-list-custom-field-serializer
EmptyMacroExpansionView	empty-macro-expansion-view
EmptyProperty	empty-property
EmptySet_PersistenceDelegate	empty-set-persistence-delegate
EmptyStackException	empty-stack-exception
EmptyTableModel	empty-table-model
EnableAsyncMappingFactory	enable-async-mapping-factory
EnableWatchExpressionAction	enable-watch-expression-action
Enabled	enabled
EnclosureResolver	enclosure-resolver
EncodingRenderer	encoding-renderer
EncryptedPartsFactory	encrypted-parts-factory
EncryptionItem	encryption-item
EndDecoration	end-decoration
Endpoint	endpoint
EnsureNode	ensure-node
EntityIncrementVersionProcess	entity-increment-version-process
EntityInstanceInterceptor	entity-instance-interceptor
EntityManagerCreator	entity-manager-creator
EntityMappingsMetadataModelImpl	entity-mappings-metadata-model-impl
EntityMultiInstanceSynchronizationInterceptor	entity-multi-instance-synchronization-interceptor
EntityPersistentFieldStrategy	entity-persistent-field-strategy
EntryRequest	entry-request
EnumControl	enum-control
EnumRowStatus	enum-row-status
EnumeratedType	enumerated-type
Eq	eq
EquinoxLauncherCUAction	equinox-launcher-cu-action
Erprint	erprint
ErrnoModule	errno-module
ErrorDescriptionChildren	error-description-children
ErrorDialogException	error-dialog-exception
ErrorHolder	error-holder
ErrorIncludesModel	error-includes-model
ErrorMessageResponse	error-message-response
ErrorUrlEditorModel	error-url-editor-model
ErrorsWarningsParameters	errors-warnings-parameters
EscapeSqlReference	escape-sql-reference
EvaluationCache	evaluation-cache
EvaluationResultCache	evaluation-result-cache
EvaluationStackFrameContextStatusHandler	evaluation-stack-frame-context-status-handler
EvaluatorTreeModel	evaluator-tree-model
EventBufferManager	event-buffer-manager
EventBufferResultsProvider	event-buffer-results-provider
EventListener	event-listener
ExampleFileFilter	example-file-filter
ExceptionBean	exception-bean
ExclTargetEntry	excl-target-entry
ExclusiveAccess	exclusive-access
ExclusivePositionUpdater	exclusive-position-updater
ExecutionEnvironmentFactory	execution-environment-factory
ExecutorGroup	executor-group
ExecutorGroupBar	executor-group-bar
ExpansionAdapter	expansion-adapter
ExplorerActionsImpl	exploreraction-simpl
ExplorerTreeNode	explorer-tree-node
ExportDataDumper	export-data-dumper
ExportHandler	export-handler
ExportSvg	export-svg
ExportToHTMLAction	export-to-html-action
ExportedPackageImpl	exported-package-impl
ExportedPackagesAction	exported-packages-action
ExposedTypeVisitor	exposed-type-visitor
ExprExpression	expr-expression
ExpressionDocumenter	expression-documenter
ExpressionParseTree	expression-parse-tree
ExtCheck	ext-check
ExtSyntaxSupport	ext-syntax-support
ExtToolBarFactory	ext-tool-bar-factory
ExtendSelector	extend-selector
ExtendedDistributionData	extended-distribution-data
ExtendedFormAuthenticator	extended-form-authenticator
ExtendedSatelliteComponent	extended-satellite-component
ExtendedTestabilityFilter	extended-testability-filter
ExtensionParameterValues	extension-parameter-values
ExtensionStateModel	extension-state-model
ExtensionValidator	extension-validator
ExtensionsBlock	extensions-block
ExternalClassFileEditorInput	external-class-file-editor-input
ExternalFeatureModelManager	external-feature-model-manager
ExternalPackage	external-package
ExternalProgramImageDescriptor	external-program-image-descriptor
ExternalTerminal	external-terminal
ExternalToolsUtil	external-tools-util
ExtractClassDescriptor	extract-class-descriptor
ExtractConstantRefactoring	extract-constant-refactoring
ExtractLibraryHandler	extract-library-handler
F	f
FF	ff
FL	fl
FLOAD	fload
FMFileUnlimited	fm-file-unlimited
FN	fn
FR	fr
FacebookSocialNetworkingService	facebook-social-networking-service
FaceletContextObject	facelet-context-object
FailedDownloadException	failed-download-exception
FakeBidirectionalRelationWorkUnit	fake-bidirectional-relation-work-unit
FalseFinder	falsefinder
FastHashMap	fasthashmap
FatalIOException	fatal-io-exception
FcbAction	fcb-action
FeatureDetailsSection	feature-details-section
FeatureEntry	feature-entry
FeatureLicensePropertyPage	feature-license-property-page
FeatureOptionsTab	feature-options-tab
FeatureReference	feature-reference
FeatureReferenceAdapter	feature-reference-adapter
FeaturesAction	features-action
FeedReaderWizardPanel	feed-reader-wizard-panel
FeedbackSurvey	feedback-survey
FetchDescriptor	fetch-descriptor
FetchReturn	fetch-return
Fetcher	fetcher
FieldBuilder	field-builder
FieldData	field-data
FieldInfoEditingSupport	field-info-editing-support
FieldNode	field-node
FieldTreeNode	field-treen-ode
FigClassAssociationClass2	fig-class-association-class-2
FigDestroyActionMessage	fig-destroy-action-message
FigEdgeModelElement	fig-edge-model-element
FigOperation	fig-operation
FigPackage	fig-package
FigState	fig-state
FigureWidget	figure-widget
FileChooserPainter	file-chooser-painter
FileChooserPanel	file-chooser-panel
FileEvent	file-event
FileIndexer	file-indexer
FileListener	file-listener
FileMapStorage	file-map-storage
FileNameSortedKey	file-name-sorted-key
FileObjectAccessor	file-object-accessor
FileResolverImpl	file-resolver-impl
FileSystemView	file-system-view
FileSystemsProvider	file-systems-provider
FileUploadIOException	file-upload-io-exception
FileUploadServletProgressAdapter	file-upload-servlet-progress-adapter
FileUtilities	file-utilities
FilesChangedDialog	files-changed-dialog
FilesystemTracker	file-system-tracker
FillPath	fill-path
FillPieDataset	fill-pie-dataset
FillPrepareResult	fill-prepare-result
FilterActivity	filter-activity
FilterChainProviderImplementation	filter-chain-provider-implementation
FilterConsumer	filter-consumer
FilterCopy	filter-copy
FilterExprWalker	filter-expr-walker
FilterJob	filter-job
FilterKey	filter-key
FilterLabelProvider	filter-label-provider
FilterMap	filter-map
FilterMappingRemoveElement	filter-mapping-remove-element
FilterMappingsTableModel	filter-mappings-table-model
FilterProblemResolution	filter-problem-resolution
FilterQueryPlan	filter-query-plan
FilterStyledDocument	filter-styled-document
FilterTestCase	filter-test-case
FilterTypeComboBoxModel	filter-type-combo-box-model
FilteredLimitEstimate	filtered-limit-estimate
FilteringAnnotationIterator	filtering-annotation-iterator
Filters	filters
FindBugsDisplayFeatures	find-bugs-display-features
FindDeclarationsInWorkingSetAction	find-declarations-in-working-set-action
FindInFileActionDelegate	find-in-file-action-delegate
FindInFilesOperator	find-in-files-operator
FindReadReferencesInHierarchyAction	find-read-references-in-hierarchy-action
FindRefComparison	find-ref-comparison
FinishResult	finish-result
FirstLevelCache	first-level-cache
FitToPage	fit-to-page
FixAll	fix-all
FixedHolder	fixed-holder
FixedJInternalFrame	fixed-j-internal-frame
FixedJRootPane	fixed-j-root-pane
FixedLocaleResolver	fixed-locale-resolver
FixedMeta	fixed-meta
FixedTableColumn	fixed-table-column
Fl	fl
FlattenIterator	flatten-iterator
Float32ResultConverter	float32-result-converter
FloatValueCommand	float-value-command
FlowGraphNode	flow-graph-node
FlowLayoutSupport	flow-layout-support
FlowListElementsUpdaterPresenter	flow-list-elements-updater-presenter
FlowSceneKeyAction	flow-scene-key-action
FlowSwitchDisplayableEventHandlerForwardEdgePresenter	flow-switch-displayable-event-handler-forward-edge-presenter
FlushActionListener	flush-action-listener
FoldHierarchyTransactionImpl	fold-hierarchy-transaction-impl
FoldWidget	fold-widget
Folder	folder
FolderConfigurationNode	folder-configuration-node
FolderImpl	folder-impl
FolderInfo	folder-info
FolderNameField	folder-name-field
FolderProvider	folder-provider
FoldingPreferencePage	folding-preference-page
FoldingToolTip	folding-tool-tip
FollowingSiblingTraverser	following-sibling-traverser
FontColorNames	font-color-names
FontFamily	font-family
FontMetrics	font-metrics
FontWeightList	font-weight-list
Footprint	footprint
ForFlowInfo	for-flow-info
ForeignKeyColumn	foreign-key-column
ForeignKeyListNode	foreign-key-list-node
ForkingSunRmic	forking-sun-rmic
FormData	form-data
FormFonts	form-fonts
FormHardCodedString	form-hard-coded-string
FormLAF	form-laf
FormPropertyEditorManager	form-property-editor-manager
FormSubmitCompleteEvent	form-submit-complete-event
FormTextModel	form-text-model
FormToolBar	form-tool-bar
FormatData	format-data
FormatData_ar	format-data-ar
FormatData_be	format-data-be
FormatData_bg	format-data-bg
FormatData_bg_BG	format-data-bg-bg
FormatData_ca	format-data-ca
FormatData_cs	format-data-cs
FormatData_da	format-data-da
FormatData_de	format-data-de
FormatData_el	format-data-el
FormatData_en	format-data-en
FormatData_es	format-data-es
FormatData_et	format-data-et
FormatData_fi	format-data-fi
FormatData_fr	format-data-fr
FormatData_ga	format-data-ga
FormatData_hr	format-data-hr
FormatData_hu	format-data-hu
FormatData_in	format-data-in
FormatData_is	format-data-is
FormatData_is_IS	format-data-is-is
FormatData_it	format-data-it
FormatData_iw	format-data-iw
FormatData_ja	format-data-ja
FormatData_ko	format-data-ko
FormatData_lt	format-data-lt
FormatData_lv	format-data-lv
FormatData_mk	format-data-mk
FormatData_ms	format-data-ms
FormatData_mt	format-data-mt
FormatData_nl	format-data-nl
FormatData_no	format-data-no
FormatData_pl	format-data-pl
FormatData_pt	format-data-pt
FormatData_ro	format-data-ro
FormatData_ru	format-data-ru
FormatData_sk	format-data-sk
FormatData_sl	format-data-sl
FormatData_sq	format-data-sq
FormatData_sr	format-data-sr
FormatData_sv	format-data-sv
FormatData_sv_SE	format-data-sv-se
FormatData_th	format-data-th
FormatData_tr	format-data-tr
FormatData_uk	format-data-uk
FormatData_vi	format-data-vi
FormatData_zh	format-data-zh
FormatJavadocBlock	format-javadoc-block
FormatPanel	format-panel
FormattedPrintWriter	formatted-print-writer
Formatter	formatter
FormatterForURL	formatter-for-url
FortranDiffLinkedList	fortran-diff-linked-list
FortranReader	fortran-reader
ForwardingJspApplicationContextImpl	forwarding-jsp-application-context-impl
FoundIndex	found-index
Fp	fp
FragmentForSubPartBySourceRangeFactory	fragment-for-sub-part-by-source-range-factory
FrameArray	frame-array
FrameData	frame-data
FrameTarget	frame-target
FrameWindowAdapter	frame-window-adapter
FrameworkCommandInterpreter	framework-command-interpreter
FrameworkMethod	framework-method
FreechessConsoleManager	freechess-console-manager
FreechessServer	freechess-server
FreeformSharabilityQuery	freeform-sharability-query
FreemarkerTemplateEngine	freemarker-template-engine
FreezableList	freezable-list
FrenchStemmer	french-stemmer
FruchtermanReingoldLayout	fruchterman-reingold-layout
FullValueDescriptionHelper	full-value-description-helper
FullyQualifiedElementImpl	fully-qualified-element-impl
FuncExtFunctionAvailable	func-ext-function-available
FunctionDefinitionImpl	function-definition-impl
FunctionMapperImpl	function-mapper-impl
FunctionMetricsFactory	function-metrics-factory
FunctionReader	function-reader
FuzzyAttributeImpl	fuzzy-attribute-impl
G	g
GBComponentProxy	gb-component-proxy
GBeanAttribute	g-bean-attribute
GC	gc
GDIRenderer	gdi-renderer
GElementImpl	g-element-impl
GIFMetadata	gif-metadata
GNUFortranCompiler	gnu-fortran-compiler
GOCollisionQuery	go-collision-query
GREATEST	greatest
GSInstantiatingIterator	gs-instantiating-iterator
GSOptionalDeploymentManagerFactory	gs-optional-deployment-manager-factory
GSSManagerImpl	gss-manager-impl
GStringExpression	g-string-expression
GStringTemplateEngine	g-string-template-engine
GT	gt
GTKNativeEngine	gtk-native-engine
GUIPopupMenu	gui-popup-menu
GWTProblem	gwt-problem
GameAdapter	game-adapter
GanttBarStyleFactory14	gantt-bar-style-factory-14
GanttCompareToPreviousStateBean	gantt-compare-to-previous-state-bean
GanttMPXOpen	gantt-mpx-open
GanttPreviousState	gantt-previous-state
GanttSVGRenderer	gantt-svg-renderer
GapUndoableEdit	gap-undoable-edit
GcInfoCompositeData	gc-info-composite-data
GdbDisassemblyService	gdb-disassembly-service
GdkColor	gdk-color
GdkGeometry	gdk-geometry
GenTypeSolid	gen-type-solid
GeneralName	general-name
GeneralView	general-view
GeneralXorBlit	general-xor-blit
GenerateBeanInfoAction	generate-bean-info-action
GenerateCharacter	generate-character
GeneratedCollectionAliases	generated-collection-aliases
GeneratorUtilities	generator-utilities
GenericExecutionFactory	generic-execution-factory
GenericExtensibilityElement	generic-extensibility-element
GenericMessageEndpointManager	generic-message-endpoint-manager
GenericOnlySources	generic-only-sources
GetAllStatusesResponse	get-all-statuses-response
GetHandler	get-handler
GetNameSpaceMessage	get-name-space-message
GetNonExternalizedStringsAction	get-non-externalized-strings-action
GetNumberArgumentsTest	get-number-arguments-test
GetPosition	get-position
GetProperty	get-property
GizmoOptionsXMLCodec	gizmo-options-xml-codec
GlobalAttributeImpl	global-attribute-impl
GlobalProfilingPointsProcessor	global-profiling-points-processor
GlyphListLoopPipe	glyph-list-loop-pipe
GnowsisClient	gnowsis-client
GoOperationToCollaboration	go-operation-to-collaboration
GoStateToOutgoingTrans	go-state-to-outgoing-trans
GoToSourcePerformer	go-to-source-performer
GrabFocus	grab-focus
GradientInfo	gradient-info
GrailsDebugger	grails-debugger
GrailsProjectConfig	grails-project-config
GrailsRuntimePanel	grails-runtime-panel
GrailsSettings	grails-settings
GrantNode	grant-node
GraphChangeAdapter	graph-change-adapter
GraphPageable	graph-pageable
GraphZone	graph-zone
GraphicsCards	graphics-cards
GreekLowerCaseFilter	greek-lower-case-filter
GrepEntry	grep-entry
GroovyCollections	groovy-collections
GroovyCustomizer	groovy-customizer
GroovyErrorRule	groovy-error-rule
GroovyProjectModule	groovy-project-module
GroovyRuntimeException	groovy-runtime-exception
GroupAlreadyBoundException	group-already-bound-exception
GroupListener	group-listener
GsfDocument	gsf-document
Gt	gt
GtEDerived	gte-derived
GuardedReader	guarded-reader
H	h
HARMIResponse	harmi-response
HDTimer	hd-timer
HLFImpl	hlf-impl
HTMLBuilder	html-builder
HTMLDocument	html-document
HTMLTableSectionElementImpl	html-table-section-element-impl
HTMLUListElementImpl	htmlu-list-element-impl
HTMLWeekView	html-week-view
HTTPMethods	http-methods
HTTPSession	http-session
HackUploads	hack-uploads
HalfOuterJoinNode	half-outer-join-node
HandleObjectManager	handle-object-manager
HandlerArgs	handler-args
HandlerChainsModel	handler-chains-model
HandlerEvaluator	handler-evaluator
HandlerMethod	handler-method
HandlerProxy	handler-proxy
HashMap_CustomFieldSerializer	hash-map-custom-field-serializer
HashPasswordImpl	hash-password-impl
HbPropertyValueItem	hb-property-value-item
HeaderReadableGZIPInputStream	header-readable-gzip-input-stream
HeadlessException	headless-exception
HealthItem	health-item
HelloTag	hello-tag
HelloWorldAction	hello-world-action
HelloWorldSampleWizardPanel	hello-world-sample-wizard-panel
HelpCommand	help-command
HelpData	help-data
HelpRequestedException	help-requested-exception
HelpSearchContributionItem	help-search-contribution-item
HelperAppLauncherDialog_1_9	helper-app-launcher-dialog-1-9
HelperCharSequencesSortedMap2	helper-char-sequences-sorted-map-2
HelperNamespaceDefinitionSortedMap	helper-namespace-definition-sorted-map
HexCharacter	hex-character
HexTranslator	hex-translator
HiLoKeyGenerator	hi-lo-key-generator
HibernateCodeGenWizard	hibernate-code-gen-wizard
HibernateTransactionDecoratorImpl	hibernate-transaction-decorator-impl
HideFieldByVar	hide-field-by-var
HierContextEnumerator	hier-context-enumerator
HierarchicalXMLBudget	hierarchical-xml-budget
HierarchyBinaryType	hierarchy-binary-type
HierarchyBuilder	hierarchy-builder
HierarchyRequestException	hierarchy-request-exception
HighLowRenderer	high-low-renderer
HighlightArea	highlight-area
HighlightingPanel	highlighting-panel
HintsManager	hints-manager
HippieCompletionBackwardIterator	hippie-completion-backward-iterator
HistoryComboBoxEditor	history-combo-box-editor
HitQueue	hit-queue
HoldingLogChute	holding-log-chute
Home	home
Hook	hook
Hooks	hooks
Host	host
HostCheckAnalyzer	host-check-analyzer
HostedJavaScriptEngine	hosted-java-script-engine
HotspotInternal	hotspot-internal
Hour	hour
HoverInformationControlCreator	hover-information-control-creator
HprofGCRoot	hprof-gc-root
HprofHeap	hprof-heap
HsqlTableMetaDataProvider	hsql-table-meta-data-provider
HtmlAdaptorServlet	html-adaptor-servlet
HtmlCaretAwareSourceTask	html-caret-aware-source-task
HtmlCatalog	html-catalog
HtmlPaletteInsertAction	html-palette-insert-action
HtmlRefactoringPluginFactory	html-refactoring-plugin-factory
HtmlSpecificActionsImplementationFactory	html-specificactions-implementation-factory
HtmlUnitThread	html-unit-thread
Http11NioProcessor	http11-nio-processor
HttpClient	http-client
HttpDocument	http-document
HttpExample	http-example
HttpMediaTypeNotAcceptableException	http-media-type-not-acceptable-exception
HttpTimestamper	http-timestamper
HttpUtil	http-util
HttpsUtility	https-utility
HudsonConnector	hudson-connector
HudsonInstanceImpl	hudson-instance-impl
HudsonMavenModuleBuildImpl	hudson-maven-module-build-impl
HyperlinkTreePart	hyperlink-tree-part
I	i
I1	i-1
I2	i-2
IC	ic
ID	id
IDATChunk	idat-chunk
IDDatatypeValidator	id-data-type-validator
IDEOutputListenerProvider	ide-output-listener-provider
IIORegistry	iio-registry
IL	il
INTF_REPOS	intf-repos
IO	io
IOConsoleViewer	io-console-viewer
IORHolder	ior-holder
IOSelectImpl	io-select-impl
IOWindowImpl	io-window-impl
IP	ip
IREM	irem
IS	is
ISHL	ishl
ISHR	ishr
ISO9796d1Encoding	iso9796-d1-encoding
ISUB	isub
IT	it
IconFileFilter	icon-file-filter
IconImpl	icon-impl
IconInfo	icon-info
IconListEntry	icon-list-entry
Id	id
IdClassImpl	id-class-impl
IdTransferringMergeEventListener	id-transferring-merge-event-listener
IdentityEncoder	identity-encoder
IdentityLinkedList	identity-linked-list
IdentityOutputFilter	identity-output-filter
IdentityTransformer	identity-transformer
If	if
IfCustomizer	if-customizer
IgnoreAjaxRequestException	ignore-ajax-request-exception
IgnoreWhiteSpaceComparator	ignore-white-space-comparator
IiopUrl	iiop-url
IllegalComponentStateException	illegal-component-state-exception
IllegalFormatCodePointException	illegal-format-code-point-exception
ImageFilePreview	image-file-preview
ImagePrinter	image-printer
ImageResource	image-resource
ImmediateActionRenderResponseGenerator	immediate-action-render-response-generator
ImmutableClusteredProfileSourceMetaData	immutable-clustered-profile-source-meta-data
ImpModule	imp-module
ImplIE6	impl-ie6
ImplementAllAbstractMethods	implement-all-abstract-methods
ImplementOccurrencesFinder	implement-occurrences-finder
ImplementedMethods	implemented-methods
ImplementsAbstract	implements-abstract
ImplicitFormalBinding	implicit-formal-binding
ImportChange	import-change
ImportCompletionProposal	import-completion-proposal
ImportFactory	import-factory
ImportLaunchConfigurationsWizardPage	import-launch-configurations-wizard-page
ImportLobFile	import-lob-file
ImportOrganizeLabelProvider	import-organize-label-provider
ImportantFilesNodeFactory	important-files-node-factory
ImporterTopLevel	importer-top-level
In	in
InOrderFactory	in-order-factory
IncTokenList	inc-token-list
IncludeElementImpl	include-element-impl
IncludePage	include-page
IncludeTag	include-tag
IncludeTar	include-tar
IncludeTarget	include-target
IncludeUID	include-uid
IncludedSchemaDescriptor	included-schema-descriptor
IncomingFileTransferException	incoming-file-transfer-exception
IncompatibleClassChangeError	incompatible-class-change-error
IndexConstantAction	index-constant-action
IndexOrderComparator	index-order-comparator
IndexQueryRequestor	index-query-requestor
IndexSubpath	index-subpath
IndexableDataSetProducer	indexable-dataset-producer
IndexedCollection	indexed-collection
IndexedElement	indexed-element
IndexedVariablePartition	indexed-variable-partition
IndicatorsContainer	indicators-container
Inflater	inflater
InfoNodeDecoratorBehaviour	info-node-decorator-behaviour
InformationProvider	information-provider
Ingres10Dialect	ingres10-dialect
InheritsEquals	inherits-equals
InitNotationUI	init-notation-ui
InitOperations	init-operations
InitializerElementInfo	initializer-element-info
InitializerSeqHelper	initializer-seq-helper
Injection	injection
Injector	injector
InlineAnnotationReaderImpl	inline-annotation-reader-impl
InlineLocalVariableDescriptor	inline-local-variable-descriptor
InlineNewInstanceExpression	inline-new-instance-expression
InlineTempAction	inline-temp-action
InliningVisitor	inlining-visitor
InnerClassesNode	inner-classes-node
InnerPackage	inner-package
InnerResolver	inner-resolver
InputBytecode	input-byte-code
InputControlManager	input-control-manager
InputGlobalVariable	input-global-variable
InputMethodManager	input-method-manager
InputOptionTag	input-option-tag
InputSelectTag	input-select-tag
InsertEdit	insert-edit
InsertMethodAction	insert-method-action
InsetsCustomEditor	insets-custom-editor
InspectPropertiesTask	inspect-properties-task
InspectorBug	inspector-bug
InspectorDebugPanel	inspector-debug-panel
InstallLibraryMojo	install-library-mojo
InstallMojo	install-mojo
InstallationDetailsTreeTableModel	installation-details-tree-table-model
InstallationFileObject	installation-file-object
InstalledJREsBlock	installed-jres-block
InstalledSoftwarePage	installed-software-page
InstanceDump	instance-dump
InstanceImpl	instance-impl
InstanceInfo	instance-info
InstancePropertiesVisual	instance-properties-visual
InstanceType	instance-type
InstantiatedIndexWriter	instantiated-index-writer
InstantiatedTermFreqVector	instantiated-termf-req-vector
Instantiator	instantiator
InstructionCallback	instruction-callback
InstructionList	instruction-list
InstructionPointerImageProvider	instruction-pointer-image-provider
InstrumentationAccessor	instrumentation-accessor
InstrumentationSavingAgent	instrumentation-saving-agent
IntLit_c	int-lit-c
IntVector	int-vector
IntegerCustomEditor	integer-custom-editor
IntegerTextField	integer-text-field
InterfaceRule	interface-rule
InternalLanguageElementNode	internal-language-element-node
InternalNioInputBuffer	internal-nio-input-buffer
InternalSiteManager	internal-site-manager
InterningXmlVisitor	interning-xml-visitor
IntersectionType	intersection-type
IntroImage	intro-image
IntroInfo	intro-info
IntroTemplate	intro-template
IntroURLAction	intro-url-action
IntroduceIndirectionRefactoring	introduce-indirection-refactoring
IntroduceParameterObjectWizard	introduce-parameter-object-wizard
InvalidDnDOperationException	invalid-dnd-operation-exception
InvalidJarIndexException	invalid-jar-index-exception
InvalidOutputStream	invalid-output-stream
InvalidRelationIdException	invalid-relation-id-exception
InvalidateEvent	invalidate-event
InvertedDocEndConsumerPerThread	inverted-doc-end-consumer-per-thread
InvocationExpression	invocation-expression
Is	is
IsolationLevelDataSourceRouter	isolation-level-data-source-router
IssueAction	issue-action
IssueLinker	issue-linker
It	it
ItemCommandListenerParameter	item-command-listener-parameter
ItemEvent	item-event
ItemPopupMenuListener	item-popup-menu-listener
ItemsComparator	items-comparator
IterableElement	iterable-element
IteratorTag	iterator-tag
J2EEServer	j2ee-server
J2MEProjectOperations	j2me-project-operations
J2SE	j2se
J2SEJAXWSVersionProvider	j2se-jaxws-version-provider
J2SEPlatformCreator	j2se-platform-creator
J2SEProjectTypeProfiler	j2se-project-type-profiler
J2SESampleProjectIterator	j2se-sample-project-iterator
J2eeMavenSourcesImpl	j2ee-maven-sources-impl
J2eeSpecVersionComboBoxModel	j2ee-spec-version-combo-box-model
J2seProjectOpenedHook	j2se-project-opened-hook
JAXBWizardSchemaNodeChildren	jaxb-wizard-schema-node-children
JBFindJSPServlet	jb-find-jsp-servlet
JBossContextConfig	j-boss-context-config
JBossExample2OtherSubConfigBean	j-boss-example-2-other-sub-config-bean
JBossJMSMessageEndpointFactory	j-boss-jms-message-endpoint-factory
JBossResourceServices	j-boss-resource-services
JBossSessionBean31DescriptorAdaptor	j-boss-session-bean31-descriptor-adaptor
JBossWebXmlProcessor	j-boss-web-xml-processor
JCChildren	jc-children
JCDiagnostic	jc-diagnostic
JCThrow	jc-throw
JCastExpression	j-cast-expression
JCharLiteral	j-char-literal
JCheckTree	j-check-tree
JDBCCategoryDataset	jdbc-category-dataset
JDBCCreateEntityCommand	jdbc-create-entity-command
JDBCDeleteRelationsCommand	jdbc-delete-relations-command
JDBCDriverConvertor	jdbc-driver-convertor
JDBCExceptionReporter	jdbc-exception-reporter
JDBCLoadRelationCommand	jdbc-load-relation-command
JDBCRawSqlQueryMetaData	jdbc-raw-sql-query-meta-data
JDBCRelationInterceptor	jdbc-relation-interceptor
JDBCSelectorBridge	jdbc-selector-bridge
JDBCTransaction	jdbc-transaction
JDIDebugOptions	jdi-debug-options
JDIReferenceListValue	jdi-reference-list-value
JDKClassLoader	jdk-class-loader
JDKDigestSignature	jdk-digest-signature
JEIndexOutput	je-index-output
JFBLookupMerger	jfb-lookup-merger
JFFIInvoker	jffi-invoker
JIfStatement	jif-statement
JInstanceofExpression	j-instance-of-expression
JJDoc	jj-doc
JJTreeIOException	jj-tree-io-exception
JMSStatsImpl	jms-stats-impl
JMXManagementService	jmx-management-service
JMenu	j-menu
JNDIURLStreamHandlerService	jndi-url-stream-handler-service
JNIid	jni-id
JPEGImageReaderSpi	jpeg-image-reader-spi
JRAbstractBeanDataSource	jr-abstract-bean-data-source
JRAbstractExporter	jr-abstract-exporter
JRAntCompileTask	jr-ant-compile-task
JRApiWriter	jr-api-writer
JRBar3DPlotFactory	jr-bar-3d-plot-factory
JRBaseBand	jr-base-band
JRBaseChartAxis	jr-base-chart-axis
JRBaseFiller	jr-base-filler
JRBaseGanttDataset	jr-base-gantt-dataset
JRBaseParameter	jr-base-parameter
JRBaseTimeSeriesDataset	jr-base-time-series-dataset
JRBigDecimalSumIncrementer	jr-big-decimal-sum-incrementer
JRBshEvaluator	jr-bsh-evaluator
JRByteAverageIncrementer	jr-byte-average-incrementer
JRChartSubtitleFactory	jr-chart-subtitle-factory
JRCloneUtils	jr-clone-utils
JRConcurrentSwapFile	jr-concurrent-swapfile
JRCrosstabBucketExpressionFactory	jr-cross-tab-bucket-expression-factory
JRCsvSaveContributor	jr-csv-save-contributor
JRDesignCellContents	jr-design-cell-contents
JRDesignConditionalStyle	jr-design-conditional-style
JRDesignCrosstabMeasure	jr-design-cross-tab-measure
JRDesignPieDataset	jr-design-pie-dataset
JRDesignTextField	jr-design-text-field
JRDistinctCountIncrementer	jr-distinct-count-incrementer
JRFillBar3DPlot	jr-fill-bar-3d-plot
JRFillCloneFactory	jr-fill-clone-factory
JRFillLine	jr-fill-line
JRFillScatterPlot	jr-fill-scatter-plot
JRHighLowPlotFactory	jr-high-low-plot-factory
JRHyperlinkTargetProducerMapFactory	jr-hyperlink-target-producer-map-factory
JRLinePlotFactory	jr-line-plot-factory
JRMondrianAxis	jr-mondrian-axis
JRMondrianTuple	jr-mondrian-tuple
JRPrintHyperlinkParameter	jr-print-hyperlink-parameter
JRPrintHyperlinkParameterValue	jr-print-hyperlink-parameter-value
JRRecordedValuesGenericPrintElement	jr-recorded-values-generic-print-element
JRShortSumIncrementer	jr-short-sum-incrementer
JRSingletonCache	jr-singleton-cache
JRTemplateReference	jr-template-reference
JRValueDisplayFactory	jr-value-display-factory
JRXPathQueryExecuterFactory	jr-x-path-query-executer-factory
JReboundEntryPoint	j-rebound-entry-point
JReferencedClass	j-referenced-class
JSException	js-exception
JSFPageFlowViewFactory	jsf-page-flow-view-factory
JSJavaField	js-java-field
JSONException	json-exception
JSONNull	json-null
JSObjectFactory	js-object-factory
JSRInlinerAdapter	jsr-inliner-adapter
JSUtil	js-util
JSVariable	js-variable
JSchCorePlugin	j-sch-core-plugin
JStatement	j-statement
JStaticClass	j-static-class
JTAResource	jta-resource
JTextComponentTextBinding	j-text-component-text-binding
JUMP_INDIRECT_Instr	jump-indirect-instr
JUTS_7_peer_1_pivot	juts-7-peer-1-pivot
JUnaryOperation	j-unary-operation
JUnit3Identifier	junit3-identifier
JUnit3TestFinder	junit3-test-finder
JUnit3TestReference	junit3-test-reference
JUnit4TestLoader	junit4-test-loader
JUnitClasspathFixCorrectionProposal	junit-classpath-fix-correction-proposal
JUnitFatalLaunchException	j-unit-fatal-launch-exception
JUnitStubUtility	j-unit-stub-utility
JVM_MANAGEMENT_MIB_IMPL	jvm-management-mib-impl
JWildcardType	j-wildcard-type
JakartaOroRegexp	jakarta-oro-regexp
JarFileExportOperation	jar-file-export-operation
JarOptionsPage	jar-options-page
JarPackagerUtil	jar-packager-util
JarStructureCreator	jar-structure-creator
JavaBreakIterator	java-break-iterator
JavaBrowsingMessages	java-browsing-messages
JavaCategoryPropertyPage	java-category-property-page
JavaCompletionItem	java-completion-item
JavaCompletionQuery	java-completion-query
JavaConnectTab	java-connect-tab
JavaConstantNode	java-constant-node
JavaConventions	java-conventions
JavaCorrectionAssistant	java-correction-assistant
JavaDebugElementAdapterFactory	java-debug-element-adapter-factory
JavaDebugIntegerFieldEditor	java-debug-integer-field-editor
JavaDoc2HTMLTextReader	javadoc-2-html-text-reader
JavaEESamplesWizardPanel	java-ee-samples-wizard-panel
JavaEEServerModule	java-ee-server-module
JavaEditorColoringConfigurationBlock	java-editor-coloring-configuration-block
JavaEditorTextHoverProxy	java-editor-text-hover-proxy
JavaElementContainmentAdapter	java-element-containment-adapter
JavaElementFilter	java-element-filter
JavaException	java-exception
JavaManipulationPlugin	java-manipulation-plugin
JavaMethodNBlock	java-method-n-block
JavaMethodTwoOrThreeOrNBlock	java-method-two-or-three-or-n-block
JavaNativeConsoleTracker	java-native-console-tracker
JavaNavigatorViewActionProvider	java-navigator-view-action-provider
JavaNoTypeCompletionProposalComputer	java-no-type-completion-proposal-computer
JavaOnExitCleanerHandler	java-on-exit-cleaner-handler
JavaOwnedMonitor	java-owned-monitor
JavaPackageCompletionProcessor	java-package-completion-processor
JavaParameterListValidator	java-parameter-list-validator
JavaProjectSourceLocation	java-project-source-location
JavaRunTime	java-run-time
JavaScriptURLConnection	java-script-url-connection
JavaSourceCategory	java-source-category
JavaStructureCreator	java-structure-creator
JavaTemplateMessages	java-template-messages
JavaThreadActionFilter	java-thread-action-filter
JavaTokenFilter	java-token-filter
JavaTokenMarker	java-token-marker
JavaUISourceLocator	java-ui-source-locator
JavaVariableLabelProvider	java-variable-label-provider
JavaWatchExpressionFilter	java-watch-expression-filter
JavaWrapper	java-wrapper
JavaWsdlMapper	java-wsdl-mapper
JavacRoundEnvironment	javac-round-environment
JavacardPlatform	javacard-platform
JavadocBrowserInformationControlInput	javadoc-browser-information-control-input
JavadocLinkRef	javadoc-link-ref
JavahAdapterFactory	javah-adapter-factory
JaxWsServiceCreatorProvider	jax-ws-service-creator-provider
JdbcTransactionObjectSupport	jdbc-transaction-object-support
JdkConcurrentHashMap	jdk-concurrent-hash-map
JdtViewerDropSupport	jdt-viewer-drop-support
JdwpArrayID	jdwp-array-id
JellyVersion	jelly-version
JettyHttpServerProvider	jetty-http-server-provider
JettyOutputProcessorFactory	jetty-output-processor-factory
JettyServletContainer	jetty-servlet-container
JkCoyoteHandler	jk-coyote-handler
JmsClient	jms-client
JmsProtocolHandler	jms-protocol-handler
JmsServerSessionPool	jms-server-session-pool
JobImpressionsSupported	job-impressions-supported
JoinPointImpl	join-point-impl
JreMemoryLeakPreventionListener	jre-memory-leak-prevention-listener
JsBreakUpLargeVarStatements	js-break-up-large-var-statements
JsClassPathProvider	js-class-path-provider
JsEmpty	js-empty
JsExprStmt	js-expr-stmt
JsFakeStructureItem	js-fake-structure-item
JsSwitch	js-switch
JsTry	js-try
JsUtils	js-utils
JsfCodeGenerator	jsf-code-generator
JsfEmployeeAction	jsf-employee-action
JsniRefLookup	jsni-ref-lookup
JsonUtils	json-utils
JspBreakpointsReader	jsp-breakpoints-reader
JspCompilerAdapterFactory	jsp-compiler-adapter-factory
JspElWatch	jsp-el-watch
JspFragment	jsp-fragment
JspLineBreakpoint	jsp-line-breakpoint
JspPaletteUtilities	jsp-palette-utilities
JspServletHolderWrapper	jsp-servlet-holder-wrapper
JspTagLifecycle	jsp-tag-lifecycle
JumpBackAction	jump-back-action
JvmRTLibraryPathTableMeta	jvm-rt-library-path-table-meta
K	k
KE	ke
KV	kv
KawaConvert	kawa-convert
KeepAlive	keep-alive
KernelFastDebugConfig	kernel-fast-debug-config
KeyBindingsMIMEOptionFile	key-bindings-mime-option-file
KeyComparator	key-comparator
KeyEnumeration	key-enumeration
KeyManagementException	key-management-exception
KeyReference	key-reference
KeySetIterator	key-set-iterator
KeyValuePairModell	key-value-pair-modell
KeyboardListenerAdapter	keyboard-listener-adapter
KeyedValueComparator	keyed-value-comparator
KeysPreferencePage	keys-preference-page
KeystoresPortlet	key-stores-portlet
KitInfo	kit-info
KitModuleUpdateUnitImpl	kit-module-update-unit-impl
KoptRequest	kopt-request
L	l
LE64ArrayIO	le64-array-io
LEShortFormatDef	le-short-format-def
LINE_NUM_Instr	line-num-instr
LP	lp
LR	lr
LVPosition	lv-position
LValueConstant	l-value-constant
LWPsTracker	lw-ps-tracker
LanguageListCellRenderer	language-list-cell-renderer
LanguageRegistrationProcessor	language-registration-processor
Last	last
LastIndex	last-index
LatencyLock	latency-lock
LaunchConfigurationComparator	launch-configuration-comparator
LaunchConfigurationDialog	launch-configuration-dialog
LaunchConfigurationTabImageDescriptor	launch-configuration-tab-image-descriptor
LaunchManager	launch-manager
LauncherUtils	launcher-utils
LaunchingPage	launching-page
LayerPainter	layer-painter
LayeredHighlightInfo	layered-highlight-info
LayoutThread	layout-thread
Lazy	lazy
LazyActionPerformer	lazy-action-performer
LazyBlockSym	lazy-block-sym
LazySingletonAspectInstanceFactoryDecorator	lazy-singleton-aspect-instance-factory-decorator
LazySnapshotsIt	lazy-snapshots-it
LazySortedCollection	lazy-sorted-collection
LazyStartHeader	lazy-start-header
LazyStatementImpl	lazy-statement-impl
LdapClientFactory	ldap-client-factory
LegacyEditorActionBarExpression	legacy-editor-action-bare-xpression
LegendItem	legend-item
LegendItemEntity	legend-item-entity
LibItem	lib-item
LibrariesCustomizerAction	libraries-customizer-action
LibraryDesc	library-desc
LibraryManagerChildren	library-manager-children
LicenseApprovalPanel	license-approval-panel
LifecycleException	lifecycle-exception
LifecycleManager	lifecycle-manager
LimitExceededException	limit-exceeded-exception
LimitedInputStream	limited-input-stream
LimitedSizeCharArrayWriter	limited-size-char-array-writer
LineCalendarModule	line-calendar-module
LineMetrics	line-metrics
LineNumberMapBuilder	line-number-map-builder
LineNumbersAttr	line-numbers-attr
LinesComponent	lines-component
LinesImpl	lines-impl
LinkAdapterListener	link-adapter-listener
LinkButton	link-button
LinkFactory	link-factory
LinkLanguageUtilities	link-language-utilities
LinkTree	link-tree
LinkageError	linkage-error
LinkedProposalModel	linked-proposal-model
LinuxAMD64ThreadContext	linux-amd64-thread-context
LinuxX86JavaThreadPDAccess	linuxx86-java-thread-pd-access
LispNewlineFormat	lisp-new-line-format
ListBinder	list-binder
ListDataEvent	list-data-event
ListDialogField	list-dialog-field
ListElementEventSourceCD	list-element-event-source-cd
ListImageEditor	list-image-editor
ListIndexExpression	list-index-expression
ListItems	list-items
ListSelectionArea	list-selection-area
ListTableCellRenderer	list-table-cell-renderer
ListUtil	list-util
ListenKey	listen-key
ListenerMergeHandler	listener-merge-handler
ListenerRemoveElement	listener-remove-element
LiteField	lite-field
LiveReverseMemCallGraphPanel	live-reverse-mem-call-graph-panel
LoadedResourceReference	loaded-resource-reference
LocalDSInstanceClassFactory	local-ds-instance-class-factory
LocalDemarcationStrategy	local-demarcation-strategy
LocalFileNativesManager	local-file-natives-manager
LocalFileStorage	local-file-storage
LocalHelp	local-help
LocalJBossServerDomain	local-j-boss-server-domain
LocalJavaApplicationTabGroup	local-java-application-tab-group
LocalJaxWsServiceFactoryBean	local-jax-ws-service-factory-bean
LocalNBMsProvider	local-nbms-provider
LocalSelectionTransfer	local-selection-transfer
LocalVariableAttribute	local-variable-attribute
LocalVariableImpl	local-variable-impl
LocalVariableInfo	local-variable-info
LocalVariableTableEntry	local-variable-table-entry
LocalVariableTableVisitor	local-variable-table-visitor
LocalVariableWrapper	local-variable-wrapper
LocaleAttributeImpl	locale-attribute-impl
LocaleConfigImpl	locale-config-impl
LocalizationUtility	localization-utility
LocatableAnnotation	locatable-annotation
LocationAttributes	location-attributes
LocationFileListener	location-file-listener
LocationRef	location-ref
LockFactory	lock-factory
LogAccessFile	log-access-file
LogBrokerMonitor	log-broker-monitor
LogLevelFormatException	log-level-format-exception
LogList	log-list
LogManagerPortlet	log-manager-portlet
LogTableDateRenderer	log-table-date-renderer
LogTextPanelExampleGenThread	log-text-panel-example-gen-thread
LogViewerSupport	log-viewer-support
LogicalStatementEntity	logical-statement-entity
LogicalUserNameElement	logical-user-name-element
LoginHandle	login-handle
LoginScreenExample	login-screen-example
LoginScreenLoginCommandEventSourceCD	login-screen-login-command-event-source-cd
LoopDialog	loop-dialog
LowLevelIE6	low-level-ie6
LowMemory	low-memory
LowerOffsetMatchUpdater	lower-offset-match-updater
LstatFunction	lstat-function
Lt	lt
M	m
MBeanInfoTableCellRenderer	m-bean-info-table-cell-renderer
MBeanRegistrationException	m-bean-registration-exception
MCGroupFactory	mc-group-factory
ME	me
META	meta
MIDPTargetChooserPanel	midp-target-chooser-panel
MIDletsTableModel	midlets-table-model
MIMEResolverImpl	mime-resolver-impl
MIMESupport	mime-support
MXBeanSupport	mx-bean-support
MY	my
MacArabic	mac-arabic
MacCentralEurope	mac-central-europe
MacProvider	mac-provider
MacrosListPanel	macros-list-panel
MacrosMIMEOptionFile	macros-mime-option-file
MacrosProvider	macros-provider
MailFolder	mail-folder
MailList	mail-list
MailResourceAdapter	mail-resource-adapter
MainLookup	main-lookup
MainlineDHTManagerImpl	mainline-dht-manager-impl
MakeDescriptorImpl	make-descriptor-impl
MakeElement	make-element
MakeList	make-list
MakeLogicalViewRootNode	make-logical-view-root-node
MakeProject	make-project
MakeTargetAction	make-target-action
MakefileDataNode	makefile-data-node
ManPageOSTask	man-page-os-task
ManagedEntityManagerFactoryInvocationHandler	managed-entity-manager-factory-invocation-handler
ManagedProxyFactory	managed-proxy-factory
ManagedReference	managed-reference
ManagedSessionContext	managed-session-context
ManagedTransactionAdapter	managed-transaction-adapter
MangledNameType	mangled-name-type
ManifestContentAssistProcessor	manifest-content-assist-processor
ManyToManyImpl	many-to-many-impl
MapELResolver	map-el-resolver
MapMessage	map-message
MapMessages	map-messages
MapProxy	map-proxy
MappedConfigurationOverride	mapped-configuration-override
MappedList	mapped-list
MappingOptionsPanel	mapping-options-panel
MappingPanel	mapping-panel
MappingSqlQueryWithParameters	mapping-sql-query-with-parameters
MarkComparator	mark-comparator
MarkRegionTarget	mark-region-target
MarkSet	mark-set
MarkSetProvider	mark-set-provider
MarkerResourceUtil	marker-resource-util
MarkerSelectionProviderAction	marker-selection-provider-action
MarkerTypesModel	marker-types-model
MarkupStream	markup-stream
MarsRoverViewerView	mars-rover-viewer-view
MarshalEJBCallbackHandler	marshal-ejb-callback-handler
MarshallInterceptor	marshall-interceptor
MatchJob	match-job
MatchKind	match-kind
MatchNoDocsQueryNodeBuilder	match-no-docs-query-node-builder
MatcherSchedulingRule	matcher-scheduling-rule
MatrixSeriesCollection	matrix-series-collection
MavenJaxWsLookupProvider	maven-jax-ws-lookup-provider
MavenModelUtils	maven-model-utils
MavenProjectPropsImpl	maven-project-props-impl
MavenVersionSettings	maven-version-settings
MaxStringValue	max-string-value
MaximizeAction	maximize-action
MaximumValidator	maximum-validator
MediaSizeName	media-size-name
MemberSummaryBuilder	member-summary-builder
Membership	membership
MemoryClassLoader	memory-class-loader
MemoryProtocolHandler	memory-protocol-handler
MemorySettingsAdvancedPanel	memory-settings-advanced-panel
MergeEngines	merge-engines
MergeInserter	merge-inserter
MergeOneFolderType	merge-one-folder-type
MergePolicy	merge-policy
MergeSinceOriginType	merge-since-origin-type
MergeWizard	merge-wizard
Message2StringFile	message-2-string-file
Message2URLURL	message-2-urlurl
MessageDialogWrapper	message-dialog-wrapper
MessageFormatException	message-format-exception
MessageHistoryManager	message-history-manager
MessageListenerMetaData	message-listener-meta-data
MessagePartsModel	message-parts-model
MessageRejectedWhileStoppingException	message-rejected-while-stopping-exception
MessageToken	message-token
MessagesTag	messages-tag
MessagingException	messaging-exception
MetaDataEntry	meta-data-entry
MetadataElement	metadata-element
MetadataModelException	metadata-model-exception
MetadataRepositoryManager	metadata-repository-manager
MetadataSection	metadata-section
MetalEditorTabCellRenderer	metal-editor-tab-cell-renderer
MetalInternalFrameUI	metal-internal-frame-ui
MethodData	method-data
MethodExistsAcceptor	method-exists-acceptor
MethodExitEventImpl	method-exit-event-impl
MethodIndex	method-index
MethodLoadedCommand	method-loaded-command
MethodMatchers	method-matchers
MethodPaintComponent	method-paint-component
MethodUriProvider	method-uri-provider
MexFactories	mex-factories
MfDataObject	mf-data-object
Microbenchmarks	micro-benchmarks
MidiOutReceiver	midi-out-receiver
MidpComponentProducer	midp-component-producer
MidpProjectPropertiesSupportImpl	midp-project-properties-support-impl
MidpPropertyPresenterSerializer	midp-property-presenter-serializer
MilestoneEntryExample	milestone-entry-example
MimeHeaders	mime-headers
Minst	minst
Minus	minus
MirrorImpl	mirror-impl
MissingFormatArgumentException	missing-format-argument-exception
MissingSourceFileException	missing-source-file-exception
MixerClipGainControl	mixer-clip-gain-control
MixerSourceLine	mixer-source-line
MixerSourceLinePanControl	mixer-source-line-pan-control
MjType	mj-type
MockPortletConfig	mock-portlet-config
MockPortletRequestDispatcher	mock-portlet-request-dispatcher
MockProxyMetaClass	mock-proxy-meta-class
MockResourceURL	mock-resource-url
MockWebApplication	mock-web-application
ModalityEvent	modality-event
ModeChangeCellModifier	mode-change-cell-modifier
ModelChangeLabelProvider	model-change-label-provider
ModelFieldEdit	model-field-edit
ModelFileAdapter	model-file-adapter
ModelParticipantChangeSetCapability	model-participant-change-set-capability
ModelProviderResourceMapping	model-provider-resource-mapping
ModelXMLRootContext	model-xml-root-context
ModificationWatchpointEventWrapper	modification-watchpoint-event-wrapper
ModifiedSearchView	modified-search-view
ModifierPanel	modifier-panel
ModuleConfig	module-config
ModuleDeleterImpl	module-deleter-impl
ModuleImpl	module-impl
ModuleInfo	module-info
ModuleItem	module-item
ModuleLoader2	module-loader-2
ModuleNodeList	module-node-list
ModuleResult	module-result
MoeActionWithOrWithoutSelection	moe-action-with-or-without-selection
MoePrinter	moep-rinter
MonitorListModel	monitor-list-model
MoreBuildActionsAction	more-build-actions-action
MotifMenuMouseListener	motif-menu-mouse-listener
MotifPopupMenuUI	motif-popup-menu-ui
MoveClassPanel	move-class-panel
MoveFilesFoldersAndCusPolicy	move-files-folders-and-cus-policy
MoveLinesAction	move-lines-action
MoveProjectAction	move-project-action
MoveSourceEdit	move-source-edit
MoveTaskInteractions	move-task-interactions
MovedModelElement	moved-model-element
MppClean	mpp-clean
MsgDestTextFieldEditorModel	msg-dest-text-field-editor-model
MsgTrace	msg-trace
MsggenMessages	msg-gen-messages
MtomConfigurationProvider	mtom-configuration-provider
MtomStreamWriterImpl	mtom-stream-writer-impl
MultiFileLoader	multi-file-loader
MultiFileSystem	multi-file-system
MultiLineCleanUpContext	multi-line-clean-up-context
MultiMenuBarUI	multi-menu-bar-ui
MultiProtocolRetrieveAdapterFactory	multi-protocol-retrieve-adapter-factory
MultiStateCompilationUnitChange	multi-state-compilation-unit-change
MultiTestSuite	multi-test-suite
MultiTypeDeclarationPattern	multi-type-declaration-pattern
MultipartFilter	multi-part-filter
MultipleGradientPaintContext	multiple-gradient-paint-context
MultipleMatchesException	multiple-matches-exception
MultiplexingURLStreamHandler	multiplexing-url-stream-handler
MutableActivityManager	mutable-activity-manager
MutableInt	mutable-int
MutablePersistenceUnitInfo	mutable-persistence-unit-info
MutationInfo	mutation-info
MyErrorHandler	my-error-handler
MyFacesModuleBuilderExtension	my-faces-module-builder-extension
MyHoverProvider	my-hover-provider
MyInterruptor	my-interruptor
MyJettyLauncher	my-jetty-launcher
MyNamespaceContext	my-namespace-context
MyNode	my-node
MyRandomAccessFile	my-random-access-file
MySQLDataHandler	my-sql-data-handler
MyScrollPane	my-scroll-pane
MyTrackerView	my-tracker-view
MyTreeSelectionListener	my-tree-selection-listener
N	n
N1	n-1
N2	n-2
NA	na
NAugAssign	n-aug-assign
NBArtifactInfo	nb-artifact-info
NBBuildPlanner	nb-build-planner
NBGroupInfo	nb-group-info
NBinding	n-binding
ND	nd
NExec	n-exec
NIVFix	niv-fix
NL	nl
NLSUIMessages	nlsui-messages
NOPLogger	nop-logger
NR	nr
NRaise	n-raise
NS4DOMObject	ns4-dom-object
NailMain	nail-main
NameAbbreviator	name-abbreviator
NameAlreadyBoundHelper	name-already-bound-helper
NameModifier	name-modifier
NamedElementDescriptorImpl	named-element-descriptor-impl
NamedObject	named-object
NamedParameterJdbcTemplate	named-parameter-jdbc-template
NamedPart	named-part
NamespaceResultItem	namespace-result-item
NamingNodeFactory	naming-node-factory
NatPMPImpl	nat-pmp-impl
NativeGSSFactory	native-gss-factory
NativeGenerator	native-generator
NativeJavaPackage	native-java-package
NativeKeyFormatter	native-key-formatter
NativeModule	native-module
NativeSQLQueryNonScalarReturn	native-sql-query-non-scalar-return
NativeSQLQueryPlan	native-sql-query-plan
NativeStrike	native-strike
NativeString	native-string
NativeWindowSystem	native-window-system
NavigableCommonViewer	navigable-common-viewer
NavigationHistoryAction	navigation-history-action
NavigationHistoryItem	navigation-history-item
Navigator	navigator
NavigatorContent	navigator-content
NavigatorPipelineService	navigator-pipeline-service
NavigatorTC	navigator-tc
NavigatorUI	navigator-ui
NbEditorUtilities	nb-editor-utilities
NbEnumResultItem	nb-enum-result-item
NbKeymap	nb-key-map
NbPlatformListModel	nb-platform-list-model
NbPresenter	nb-presenter
NbiRadioButton	nbi-radio-button
NbiTextField	nbi-text-field
NbiTreeTableColumnRenderer	nbi-tree-table-column-renderer
NegativeArraySizeException	negative-array-size-exception
NestedElement	nested-element
NestedExceptionUtils	nested-exception-utils
NetBeansOrgEntry	net-beans-org-entry
NetworkServerMBeanImpl	network-server-m-bean-impl
NewCategoryCreationOperation	new-category-creation-operation
NewCategoryDefinitionWizard	new-category-definition-wizard
NewCategoryNameDialog	new-category-name-dialog
NewContainerWizardPage	new-container-wizard-page
NewCtxHelpWizardPage	new-ctx-help-wizard-page
NewDateTagAction	new-date-tag-action
NewJavaFileWizardOperator	new-java-file-wizard-operator
NewMethodCorrectionProposal	new-method-correction-proposal
NewNodeDialog	new-node-dialog
NewPersonAction	new-person-action
NewPreviousSiblingAction	new-previous-sibling-action
NewProjectCreationFromTemplatePage	new-project-creation-from-template-page
NewTargetDefinitionWizard	new-target-definition-wizard
NewTestCUnitPanel	new-test-c-unit-panel
NewWebFreeFormActionsStepOperator	new-web-free-form-actions-step-operator
NewWizardMenu	new-wizard-menu
NewsFeed	news-feed
NfaState	nfa-state
NilNode	nil-node
NimbusEditorTabCellRenderer	nimbus-editor-tab-cell-renderer
NlsHelp	nls-help
NoCompilersPanel	no-compilers-panel
NoFramesView	no-frames-view
NoIndexProvider	no-index-provider
NoSelectedServerWarning	no-selected-server-warning
NoSuchGameException	no-such-game-exception
NodeByPositionVisitor	node-by-position-visitor
NodeCellList	node-cell-list
NodeFactoryTransformer	node-factory-transformer
NodeNoteRegistration	node-note-registration
NodeSelectionListener	node-selection-listener
NodeTypes	node-types
NodesThread	nodes-thread
NonRecursiveSerializer	non-recursive-serializer
NonVisualChildren	non-visual-children
NonfairSync	nonfair-sync
NormalMethodChooser	normal-method-chooser
NormalizerImpl	normalizer-impl
NotCancelableProgressMonitor	not-cancelable-progress-monitor
NotEq	not-eq
NotExistent	not-existent
NotIn	not-in
NotManagedMap	not-managed-map
NotationNameImpl	notation-name-impl
NotationSettings	notation-settings
NoteDeleteDialog	note-delete-dialog
NoticeReference	notice-reference
NotificationListenerHolder	notification-listener-holder
NotificationResources_de	notification-resources-de
NotificationResources_es	notification-resources-es
NotificationResources_fr	notification-resources-fr
NotificationWrapperSupport	notification-wrapper-support
NullEmbedderLogger	null-embedder-logger
NullReader	null-reader
NullURLStreamHandlerService	null-url-stream-handler-service
NullValidConnectionChecker	null-valid-connection-checker
NumberCell	number-cell
NumberCompare	number-compare
NumberFormatException	number-format-exception
NumberFormatProvider	number-format-provider
NumberNumberDiv	number-number-div
NumericLiteral	numeric-literal
NumericTypeCompiler	numeric-type-compiler
OIDTDCacheable	oidtd-cacheable
OIRPage	oir-page
OK	ok
OL	ol
OR	or
OS	os
OSGiPreferencesServiceTemplate	os-gi-preferences-service-template
ObjectAdapterBase	object-adapter-base
ObjectArrayInstanceImpl	object-array-instance-impl
ObjectComponentEventResultProcessor	object-component-event-result-processor
ObjectIdentifier	object-identifier
ObjectKeyFactoryImpl	object-keyfactory-impl
ObjectMethods	object-methods
ObjectReferenceImpl	object-reference-impl
Objects	objects
OccurrencesFinderImpl	occurrences-finder-impl
OffenderXMLHelper	offender-xml-helper
OffsetKind	offset-kind
OldMouseMotionListenerImpl	old-mouse-motion-listener-impl
OldObjectKeyTemplateBase	old-object-key-template-base
OnAntProcessFinishedListener	on-ant-process-finished-listener
OnMissing	on-missing
OneOperandInstr	one-operand-instr
Op	op
OpenBitSetDISI	open-bit-set-disi
OpenBrowserWorkbenchAction	open-browser-workbench-action
OpenBuildPathMarkerResolution	open-build-path-marker-resolution
OpenConfigFile	open-config-file
OpenConnectionListener	open-connection-listener
OpenEjbCorbaRefBuilder	open-ejb-corba-ref-builder
OpenExternalToolsConfigurations	open-external-tools-configurations
OpenFileDialogFilter	open-file-dialog-filter
OpenLocationAction	open-location-action
OpenManifestAction	open-manifest-action
OpenNewPageMenu	open-new-page-menu
OpenRecentProjectAction	open-recent-project-action
OpenSearchDialogPageAction	open-search-dialog-page-action
OpenTypeAction	open-type-action
OpenTypeInHierarchyAction	open-type-in-hierarchy-action
OperationGenerator	operation-generator
OptimisticTransactionalAccess	optimistic-transactional-access
OptionConverter	option-converter
OptionGroupEnd	option-group-end
OptionListener	option-listener
OptionLister	option-lister
OptionTemplateSection	option-template-section
Options	options
Or	or
Ordering	ordering
OriginProperty	origin-property
Os	os
OthersRootChildren	others-root-children
OthersRootNode	others-root-node
OutOfOrderOneComparatorNonScoringCollector	out-of-order-one-comparator-non-scoring-collector
OutOfOrderTopScoreDocCollector	out-of-order-top-score-doc-collector
OutPort	out-port
OutWriter	out-writer
OuterJoinableAssociation	outer-joinable-association
OutlineNode	outline-node
OutlinePopupFactory	outline-popup-factory
OutlineResource	outline-resource
OutputBuffer	output-buffer
OutputFileManager	output-file-manager
OutputLocationAdapter	output-location-adapter
OutputStreamAdapter	output-stream-adapter
OutputStreamWriter	output-stream-writer
OvalIcon	oval-icon
OverLIBToolTipTagFragmentGenerator	over-lib-tool-tip-tag-fragment-generator
OverlayLayout	overlay-layout
OverrideAnnotation	override-annotation
OverrideMethodItem	override-method-item
Overrides	overrides
OverwriteWidgetFactory	over-write-widget-factory
P	p
P11Cipher	p11-cipher
PA	pa
PDECompletionProposal	pde-completion-proposal
PDEFormTextEditorContributor	pde-form-text-editor-contributor
PDEPreferencesManager	pde-preferences-manager
PDEProjectionSourcePage	pde-projection-sourcepage
PDEQuickAssistAssistant	pde-quick-assist-assistant
PDESourceLookupDirector	pde-source-lookup-director
PDFDataNode	pdf-data-node
PFVTestAccessor	pfv-test-accessor
PGNFileSelectActionListener	pgn-file-select-action-listener
PHPBracesMatcher	php-braces-matcher
PHPIncludesFilter	php-includes-filter
PHPMethodStructureItem	php-method-structure-item
PHPTokenMarker	php-token-marker
PHPTypeDescriptor	php-type-descriptor
PHPVarComment	php-var-comment
PHyperlinkProcessor	p-hyperlink-processor
PIDLoopControler	pid-loop-controler
PKIXExtensions	pkix-extensions
PKIXMasterCertPathValidator	pkix-master-cert-path-validator
PMFWizard	pmf-wizard
PNGFilterInputStream	png-filter-input-stream
POMModelNavigator	pom-model-navigator
POSTNETComponent	post-net-component
PP	pp
PRUDPPacketHandlerException	prudp-packet-handler-exception
PRUDPPacketHandlerStatsImpl	prudp-packet-handler-stats-impl
PRUDPTrackerCodecs	prudp-tracker-codecs
PUT_GLOBAL_VAR_Instr	put-global-var-instr
PackageCoverage	package-coverage
PackageDeclaration	package-declaration
PackageExplorerContentProvider	package-explorer-content-provider
PackageExplorerLabelProvider	package-explorer-label-provider
PackageExplorerPart	package-explorer-part
PackageFileView	package-file-view
PackagePortFigRect	package-port-fig-rect
PackagePrivate	package-private
PackageRename	package-rename
PackageSelectionDialogFieldListener	package-selection-dialog-field-listener
PackageType	package-type
PackageViewFilterNode	package-view-filter-node
Packager	packager
Packages	packages
PackerImpl	packer-impl
PacketManager	packet-manager
PacketStream	packet-stream
PageChangingEvent	page-changing-event
PageMapEntry	page-map-entry
PageSaveablePart	page-saveable-part
PageSite	page-site
PageSize	page-size
PairState	pair-state
PaletteBorder	palette-border
PaletteNameProvider	palette-name-provider
PanelModuleDetectionVisual	panel-module-detection-visual
ParallelTermDocs	parallel-term-docs
ParamDesc	param-desc
ParameterMetaData	parameter-meta-data
ParameterTypeVariable	parameter-type-variable
ParameterizedSingleTypeReference	parameterized-single-type-reference
ParameterizedTable	parameterized-table
ParametricRangeQueryNode	parametric-range-query-node
ParseEngine	parse-engine
ParserRule	parser-rule
ParserSupport19	parser-support-19
ParserSyntaxException	parser-syntax-exception
ParserTaskImpl	parser-task-impl
ParticipantManager	participant-manager
Password	password
PasswordTool	password-tool
PatchProjectDiffNode	patch-project-diff-node
PatchWorkbenchAdapter	patch-workbench-adapter
PatchedGlyph	patched-glyph
PatchedJTree	patched-j-tree
PatchedOpenInNewWindowAction	patched-open-in-new-window-action
PathConvPercent2	path-conv-percent-2
PathTransformation	path-transformation
PatternFilter	pattern-filter
PatternListSelectionListener	pattern-list-selection-listener
PayloadQNameBasedDispatcher	payload-q-name-based-dispatcher
PeakUnitsFunctor	peak-units-functor
PeerForeignNetworkConnection	peer-foreign-network-connection
PendingDialogCloser	pending-dialog-closer
PercentageEntryExample	percentage-entry-example
PerfanDataStorage	perfan-data-storage
Period	period
Perl5Target	perl5-target
Permission	permission
PermissionsCacheable	permissions-cacheable
PermissionsCatalogRowFactory	permissions-catalog-row-factory
PersistenceScopesListener	persistence-scopes-listener
PersistenceUnitInfoImpl	persistence-unit-info-impl
PersistenceUnitPresent	persistence-unit-present
PerspectiveChange	perspective-change
PertRenderer	pert-renderer
PhantomLiveRef	phantom-live-ref
PhantomReference	phantom-reference
PhpRefactoringsFactory	php-refactorings-factory
PiePlot	pie-plot
PieUtils	pie-utils
PieceListImpl	piece-list-impl
PlainTokenListProvider	plain-token-list-provider
PlatformCategoriesChildren	platform-categories-children
PlatformConfigurationFactory	platform-configuration-factory
PlatformGeneric	platform-generic
PlatformImpl82	platform-impl-82
PlatformImpl90	platform-impl-90
PlatformImpl91	platform-impl-91
PlatformUI	platform-ui
PlatformURLBaseConnection	platform-url-base-connection
Platforms	platforms
PlotOrientation	plot-orientation
PluginContainersMenu	plugin-containers-menu
PluginContentPage	plugin-content-page
PluginFileLoggerAdapater	plugin-file-logger-adapater
PluginFileParameter	plugin-file-parameter
PluginOptionsHandler	plugin-options-handler
PluginProxySelector	plugin-proxy-selector
PluginSelectionDialog	plugin-selection-dialog
PluginSingleInstanceHandler	plugin-single-instance-handler
PluginUIEvent	plugin-ui-event
PlusOperator	plus-operator
PngChunkReader	png-chunk-reader
PngEncoder	png-encoder
PointCustomEditor	point-custom-editor
PointProperty	point-property
PoissonLoadGenerator	poisson-load-generator
PojoWrapper	pojo-wrapper
PolicyChecker	policy-checker
PolymorphicFilter	polymorphic-filter
PopToHereActionProvider	pop-to-here-action-provider
PopupChecker	popup-checker
PopupImpl	popup-impl
PopupItemAddTarget	popup-item-add-target
PortComponentRefVisitor	port-component-ref-visitor
PortInfoGroupNode	port-info-group-node
PortableRemoteObject	portable-remote-object
PortalStartupListener	portal-startup-listener
PortletAnnotationMappingUtils	portlet-annotation-mapping-utils
PositionData	position-data
PositionDef	position-def
PositionedStoreStream	positioned-store-stream
PostfixExpression	postfix-expression
PostgreSQLCreateCommand	postgre-sql-create-command
PreManyRest1Post0Assigner	pre-many-rest1-post0-assigner
PrecedingSiblingIterator	preceding-sibling-iterator
PrecisionDecimalDV	precision-decimal-dv
PreexistingEntityException	preexisting-entity-exception
Preference	preference
PreferencesFactory	preferences-factory
PreferencesImportWizard	preferences-import-wizard
PrefixNameMatcher	prefix-name-matcher
PrefixParserAction	prefix-parser-action
PrefixPlusPlusOperator	prefix-plus-plus-operator
Prefs	prefs
PreparationTask	preparation-task
PreparedStatementCreatorImpl	prepared-statement-creator-impl
PrependColAction	prepend-col-action
PreprocessedTextLexerInputOperation	preprocessed-text-lexer-input-operation
PreprocessorID	preprocessor-id
PresentationUtil	presentation-util
PresentersProcessor	presenters-processor
PrestimeCPUCCTNode	prestime-cpucct-node
PreviewNode	preview-node
PreviewPatchPage2	preview-patch-page-2
PreviousEnumeration	previous-enumeration
PrimaryTypeName	primary-type-name
PrintAppletReplyMessage	print-applet-reply-message
PrintDialog	print-dialog
PrintServiceImpl	print-service-impl
PrintServiceOption	print-service-option
ProcDataProviderFactory	proc-data-provider-factory
ProcLocation	proc-location
ProcedureInstance_c	procedure-instance-c
ProcessSubmission	process-submission
ProcessingStepHandlerException	processing-step-handler-exception
Producer	producer
ProductConfigurationLogic	product-configuration-logic
ProductExtensionBranding	product-extension-branding
ProductPreferences	product-preferences
ProfileEvent	profile-event
ProfileScope	profile-scope
ProfileUML	profile-uml
ProfilerLogger	profiler-logger
ProfilerXYChart	profiler-xy-chart
ProfilesRootImpl	profiles-root-impl
ProgramHeaderTable	program-header-table
ProgressHelper	progress-helper
ProgressIndicator	progress-indicator
ProgressLineProcessor	progress-line-processor
ProgressMonitorWrapper	progress-monitor-wrapper
ProjectBuildingException	project-building-exception
ProjectCalendarException	project-calendar-exception
ProjectComponent	project-component
ProjectDescriptor	project-descriptor
ProjectFileBuiltQuery	project-file-built-query
ProjectFilterSettingsTest	project-filter-settings-test
ProjectNotOpenException	project-not-open-exception
ProjectSettingsValidator	project-settings-validator
ProjectSpecificSecurity	project-specific-security
ProjectTemplateZipHelper	project-template-zip-helper
ProjectUiModule	project-ui-module
ProjectVariableProviderManager	project-variable-provider-manager
ProjectWizardKeys	project-wizard-keys
ProjectXmlSavedHook	project-xml-saved-hook
ProjectionDocumentEvent	projection-document-event
ProjectsAdapter	projects-adapter
ProjectsListModel	projects-list-model
PropChangeL	prop-change-l
PropPanelAssociationEnd	prop-panel-association-end
PropPanelMethod	prop-panel-method
PropPanelSimpleState	prop-panel-simple-state
PropPanelSubmachineState	prop-panel-submachine-state
PropPanelUMLCollaborationDiagram	prop-panel-uml-collaboration-diagram
PropPerm	prop-perm
PropertiesDataObject	properties-data-object
PropertiesFileDocumentProvider	properties-file-document-provider
PropertiesFileEditor	properties-file-editor
PropertiesFileEditorActionContributor	properties-file-editor-action-contributor
PropertiesFileViewer	properties-file-viewer
PropertiesFolderAction	properties-folder-action
PropertiesSheet	properties-sheet
PropertyAttribItem	property-attrib-item
PropertyChangeListenerProxy	property-change-listener-proxy
PropertyConglomerate	property-conglomerate
PropertyDialog	property-dialog
PropertyEditorDate	property-editor-date
PropertyEditorSpinnerModel	property-editor-spinner-model
PropertyEditorVersion	property-editor-version
PropertyException	property-exception
PropertyExpression	property-expression
PropertyFieldReader	property-field-reader
PropertyFinder	property-finder
PropertyManager	property-manager
PropertyMatches	property-matches
PropertyOverrideBeanDefinitionParser	property-override-bean-definition-parser
PropertyPlaceholderHelper	property-placeholder-helper
PropertySheetCategory	property-sheet-category
PropertyTypeEditor	property-type-editor
ProvUI	prov-ui
ProvUIMessages	prov-ui-messages
ProviderApiMessages	provider-api-messages
ProviderConfigImpl	provider-config-impl
ProviderProperty	provider-property
ProviderUtil	provider-util
ProvisioningOperationRunner	provisioning-operation-runner
ProxyBypass	proxy-bypass
ProxyMetaClass	proxy-meta-class
ProxyTree	proxy-tree
Ps	ps
PullUpRefactoringProcessor	pull-up-refactoring-processor
Pump	pump
PuntErrorDiagnoser	punt-error-diagnoser
Push	push
PushDouble	push-double
PushDownTransformer	push-down-transformer
PushStaticFieldVariable	push-static-field-variable
Pvcs	pvcs
Py	py
PyCursor	py-cursor
PyMapKeyValSet	py-map-key-val-set
PyMapSet	py-map-set
PyModuleDerived	py-module-derived
PySetIter	py-set-iter
PyStringConstant	py-string-constant
PyTraceback	py-trace-back
PythonObjectInputStream	python-object-input-stream
PythonTraceFunction	python-trace-function
Q2	q-2
QP	qp
QQ	qq
QQNodeToken	qq-node-token
QtTranslationDataObject	qt-translation-data-object
Quantizer	quantizer
QueryBinder	query-binder
QueryImpl	query-impl
QueryNodeParseException	query-node-parse-exception
QuerySelect	query-select
QueryTranslatorImpl	query-translator-impl
QueryVTIHelper	query-vti-helper
QueryableMetadataRepositoryManager	queryable-metadata-repository-manager
QueryableRepositoryManager	queryable-repository-manager
QueueCell	queue-cell
QueueClosedException	queue-closed-exception
QuickAccessEntry	quick-access-entry
QuickDiffToggleAction	quick-diff-togglea-ction
QuickFixPage	quick-fix-page
QuitMessage	quit-message
QuotedStringMarker	quoted-string-marker
R	r
RA	ra
RADMenuComponent	rad-menu-component
RCompileEventImpl	r-compile-event-impl
RE	re
READER	reader
REException	re-exception
RESTSampleWizardIterator	rest-sample-wizard-iterator
RESyntaxException	re-syntax-exception
RIOptimisticProvider	ri-optimistic-provider
RMIConnector	rmi-connector
RMSunFactories	rm-sun-factories
ROEditor	ro-editor
RPCResponse	rpc-response
RPNoObjectIDException	rp-no-object-id-exception
RPObjectNoLongerExistsException	rp-object-no-longer-exists-exception
RSAPrivateCrtKeyImpl	rsa-private-crt-key-impl
RSAPublicKeyImpl	rsa-public-key-impl
RSAPublicKeyStructure	rsa-public-key-structure
RadioRenderer	radio-renderer
RailsLogicalViewProvider	rails-logical-view-provider
RailsMigrationTypeMapper	rails-migration-type-mapper
RakeTaskReader	rake-task-reader
RandomlyFailsProcessor	randomly-fails-processor
RangeFilterBuilder	range-filter-builder
RangeQueryNodeBuilder	range-query-node-builder
RangeResult	range-result
RapidTypeAnalysis	rapid-type-analysis
RaplaClipboard	rapla-clipboard
RaplaStandaloneLoader	rapla-standalone-loader
RaplaStartupEnvironment	rapla-startup-environment
RationalPatterns	rational-patterns
RdbmsOperation	rdbms-operation
ReachablePlugin	reachable-plugin
ReadIterator	read-iterator
ReadOnlyAccessFilter	read-only-access-filter
ReadReturnShouldBeChecked	read-return-should-be-checked
ReadTable	read-table
ReaderToUTF8Stream	reader-to-utf8-stream
ReadlineConsole	readline-console
RealDistinctScalarAggregateStatistics	real-distinct-scalar-aggregate-statistics
RealInstantiationHelper	real-instantiation-helper
RealNestedLoopJoinStatistics	real-nested-loop-join-statistics
RealNestedLoopLeftOuterJoinStatistics	real-nested-loop-left-outer-join-statistics
RealOnceResultSetStatistics	real-once-result-set-statistics
Reaper	reaper
RecentProjectsCache	recent-projects-cache
RecentViewList	recent-view-list
ReconfigureProvider	reconfigure-provider
RecordRebinds	record-rebinds
Rectangle2D	rectangle-2d
RectangularCompactor	rectangular-compactor
RecursionCheckVisitor	recursion-check-visitor
RefactoringArguments	refactoring-arguments
RefactoringCommit	refactoring-commit
RefactoringContributionManager	refactoring-contribution-manager
RefactoringHistoryErrorPage	refactoring-history-error-page
RefactoringModifications	refactoring-modifications
ReferenceLookupVisitor	reference-lookup-visitor
ReferenceNotInitializedException	reference-not-initialized-exception
ReferenceProviderDescriptor	reference-provider-descriptor
ReferenceWrapper	reference-wrapper
ReferencesSearch	references-search
ReflectedCallData	reflected-call-data
RegexPatternMatcherExpression	regex-pattern-matcher-expression
RegexStringMatcher	regex-string-matcher
RegexpPropertyMatcher	regexp-property-matcher
RegionException	region-exception
RegisterCtxHelpWizardPage	register-ctx-help-wizard-page
RegisterHighlightAssistance	register-highlight-assistance
RegisterHighlightsSequence	register-highlights-sequence
RegistryProviderFactory	registry-provider-factory
RelationshipInfo	relationship-info
ReleaseNoteReader	release-note-reader
ReloadTask	reload-task
RelocateAction	relocate-action
RememberBytesInputStream	remember-bytes-input-stream
RememberedOffset	remembered-offset
RemoteAddress	remotea-ddress
RemoteBinaryService	remote-binary-service
RemoteDebuggerServer	remote-debugger-server
RemoteDirectory	remote-directory
RemoteFolderTreeBuilder	remote-folder-tree-builder
RemoteHelp	remote-help
RemoteLookupFailureException	remote-lookup-failure-exception
RemoteOpenResult	remote-open-result
RemoteReader	remote-reader
RemoteTestRunner	remote-test-runner
RemoveActionsFilterNode	remove-actions-filter-node
RemoveAllSearchesAction	remove-all-searches-action
RemoveCloner	remove-cloner
RemoveCmd	remove-cmd
RemoveFilter	remove-filter
RemoveUnknownExecEnvironments	remove-unknown-exec-environments
RemoveUnusedLibrariesDeclarationHintFix	remove-unused-libraries-declaration-hint-fix
RenameLinkedMode	rename-linked-mode
RenameTree	rename-tree
RenderBuffer	render-buffer
RenderStrategy	render-strategy
RendererChangeEvent	renderer-change-event
ReorgCorrectionsSubProcessor	reorg-corrections-sub-processor
Replace	replace
ReplaceBadChars	replace-bad-chars
ReplicationMessage	replication-message
ReplicationMessageReceive	replication-message-receive
ReplyMessage_1_0	reply-message-1-0
ReplyMessage_1_1	reply-message-1-1
ReplyMessage_1_2	reply-message-1-2
ReportXml	report-xml
ReportingDetectorFactorySelector	reporting-detector-factory-selector
RepositoryAccessor	repository-accessor
RepositoryDialogPanel	repository-dialog-panel
RepositoryException	repository-exception
RepositoryHolder	repository-holder
RepositoryIdSeqHelper	repository-id-seq-helper
RepositoryLocationSchedulingRule	repository-location-scheduling-rule
RepositoryNode	repository-node
RepositoryUtils	repository-utils
Request	request
RequestCallbackAdapter	request-callback-adapter
RequestContext	request-context
RequestFactoryJsonImpl	request-factory-json-impl
RequireServerEntropyImpl	require-server-entropy-impl
RequiredBundleDescription	required-bundle-description
RequiredPluginsClasspathContainer	required-plugins-classpath-container
RequiredProperty	required-property
RequiredStringValidatorDescription	required-string-validator-description
RerunLastAction	rerun-last-action
RerunLastFailedFirstAction	rerun-last-failed-first-action
RescanTask	rescan-task
ReschedulingRunnable	rescheduling-runnable
ReservationWriter	reservation-writer
ResetSystemSoftTask	reset-system-soft-task
ResolutionResult	resolution-result
ResolveClassSignature	resolve-class-signature
ResolverDefault	resolver-default
ResourceCellStyle	resource-cell-style
ResourceDownloaderErrorImpl	resource-downloader-error-impl
ResourceDragAndDropEditor	resource-drag-and-drop-editor
ResourceDropAdapterAssistant	resource-drop-adapter-assistant
ResourceElement	resource-element
ResourceIndicatorsComponent	resource-indicators-component
ResourceItemDetailsLabelProvider	resource-item-details-label-provider
ResourceLocator	resource-locator
ResourceManagerManger	resource-manager-manger
ResourceMappingHierarchyArea	resource-mapping-hierarchy-area
ResourceMappingInputScope	resource-mapping-input-scope
ResourceModel	resource-model
ResourceModelSorter	resource-model-sorter
ResourceModifications	resource-modifications
ResourceNode	resource-node
ResourcePanel	resource-panel
ResourceRefGroupNode	resource-ref-group-node
ResourceSaver	resource-saver
ResourceTranslator	resource-translator
ResourceVariableNode	resource-variable-node
ResourcesHolder	resources-holder
RestrictionViolationException	restriction-violation-exception
ResultSetJXTable	result-set-jx-table
ResynchronizeEclipseAction	resynchronize-eclipse-action
RetargetBreakpointAction	retarget-breakpoint-action
ReturnPathTypeAnalysis	return-path-type-analysis
ReturnRecord	return-record
ReusableHelpPart	reusable-help-part
RevPtrsTreeNodeAdapter	rev-ptrs-tree-node-adapter
ReverbForm	reverb-form
RevertConfigurationWizard	revert-configuration-wizard
RevertType	revert-type
RevisionDoesNotExistException	revision-does-not-exist-exception
RevisionInfoQueryCreator	revision-info-query-creator
RewriteMethod	rewrite-method
RhtmlBracesMatcherFactory	rhtml-braces-matcher-factory
RightBorder	right-border
RippleMethodFinder2	ripple-method-finder-2
RmdirAction	rmdir-action
RolloverMarginBorder	roll-over-margin-border
RootBeanDefinition	root-bean-definition
RootEntry	root-entry
RootIUAction	root-iu-action
RootIUAdvice	root-iu-advice
RootLayout	root-layout
RootTreeNodeAdapter	root-tree-node-adapter
RotateLens	rotate-lens
RowFilter	row-filter
RowOrderingImpl	row-ordering-impl
RpcCollectorKey	rpc-collector-key
RpcCommandVisitor	rpc-command-visitor
RubberBandNode	rubber-band-node
RubyClassDeclarationFinder	ruby-class-declaration-finder
RubyDebuggerEngineProvider	ruby-debugger-engine-provider
RubyGC	ruby-gc
RubyHints	ruby-hints
RubyIO	ruby-io
RubyIndexer	ruby-indexer
RubyKeywordCompleter	ruby-keyword-completer
RubyOptionsAdvancedPanel	ruby-options-advanced-panel
RubyProjectModuleInstaller	ruby-project-module-installer
RubyRational	ruby-rational
RubyThread	ruby-thread
RubyTokenList	ruby-token-list
RulerToggleBreakpointActionDelegate	ruler-toggle-breakpoint-action-delegate
RulesEngine	rules-engine
RunAppletDialog	run-applet-dialog
RunAsLoginModule	run-as-login-module
RunEvent	run-event
RunHistoryMenuAction	run-history-menu-action
RunReport	run-report
RunSQLSelectionAction	run-sql-selection-action
RunStyleRemoteWeb	run-style-remote-web
RunStyleSelenium	run-style-selenium
RunnerTreeModel	runner-tree-model
RuntimeTypeRefImpl	runtime-type-ref-impl
S	s
S9	s-9
SAAJAttachment	saaj-attachment
SAAJGBean	saaj-g-bean
SASTORE	sastore
SAXAnnotationAdapter	sax-annotation-adapter
SAXFieldAdapter	sax-field-adapter
SAXParserFactoryImpl	sax-parserfactory-impl
SAXParserImpl	sax-parser-impl
SDKConfigPanel	sdk-config-panel
SMSReceive	sms-receive
SOAP11Fault	soap11-fault
SOAP12AddressImpl	soap12-addres-simpl
SOAP12Constants	soap12-constants
SOAP12NamespaceConstants	soap12-namespace-constants
SOAP1_2Name	soap12-name
SOAPComponentValidator	soap-component-validator
SOAPHeader	soap-header
SOAPMessageFactory1_1Impl	soap-message-factory1-1-impl
SOSMarkerSegment	sos-marker-segment
SP	sp
SPARCLdstubInstruction	sparc-ldstub-instruction
SPARCSpecialRegisterInstruction	sparc-special-register-instruction
SPARCSwapInstruction	sparc-swap-instruction
SPARCV9FlushwInstruction	sparcv9-flushw-instruction
SQLHistoryView	sql-history-view
SQLLoginModule	sql-login-module
SQLTypes	sql-types
SSEMoveDecoder	sse-move-decoder
SSIPrintenv	ssi-print-env
ST	st
STSWizardCreator	sts-wizard-creator
SVGComponentInspectorFolderPresenter	svg-component-inspector-folder-presenter
SVGComponentSourcePinPresenter	svg-component-source-pin-presenter
SVGSlider	svg-slider
SVGTextField	svg-text-field
SWTChartEditor	swt-chart-editor
SWTGraphics2D	swt-graphics-2d
SWTSkinUtils	swt-skin-utils
SWTVersionGetter	swt-version-getter
SYSCONSTRAINTSRowFactory	sys-constraints-row-factory
SaasGroup	saas-group
SafeIntegralArithmetic	safe-integral-arithmetic
ScalaOutputListenerProvider	scala-output-listener-provider
Scalar	scalar
ScaleMaximumProperty	scale-maximum-property
ScanManagerConfig	scan-manager-config
ScannerUtil	scanner-util
SceneListAdapter	scene-list-adapter
ScheduledRPFutureTask	scheduled-rp-future-task
ScheduledTaskRegistrar	scheduled-task-registrar
Schema2BeansProcessor	schema-2-beans-processor
Schema2BeansUtil	schema-2-beans-util
SchemaFactoryLoader	schema-factory-loader
SchemaInputContextManager	schema-input-context-manager
SchemaParseException	schema-parse-exception
SchemaPatternBuilder	schema-pattern-builder
SchemaTransformer	schema-transformer
ScopeHandle	scope-handle
ScopeSet	scope-set
ScopesHashModel	scopes-hash-model
ScoreDoc	score-doc
ScrapbookMain1	scrapbook-main-1
ScreenDeviceInfo	screen-device-info
ScriptConfiguration	script-configuration
ScriptEngineFactoryBase	script-engine-factory-base
ScrollAction	scroll-action
ScrollPopupMenu	scroll-popup-menu
ScrollbarBeanInfo	scrollbar-bean-info
SearchConceptAnnotation	search-concept-annotation
SearchGroup	search-group
SearchInfoFactory	search-info-factory
SearchResultView	search-result-view
SearchResults	search-results
SearchResultsTabArea	search-results-tab-area
SearchScopeNodeSelection	search-scope-node-selection
SearchSettingsChanged	search-settings-changed
SecurityAdapterImpl	security-adapter-impl
SecurityCheckerImpl	security-checker-impl
SecurityException	security-exception
SecurityFlushSessionListener	security-flush-session-listener
SecurityKeyManager	security-key-manager
SecurityRoleMappingMultiViewElement	security-role-mapping-multi-view-element
SecurityRoleMappingNameEditorModel	security-role-mapping-name-editor-model
SecurityRolePanel	security-role-panel
SecurityRoleTablePanel	security-role-table-panel
SecurityRow	security-row
SecurityUtilities	security-utilities
SelectListener	select-listener
SelectModelImpl	select-model-impl
SelectModelRenderer	select-model-renderer
SelectPathAction	select-path-action
SelectionCallState	selection-call-state
SelectionChangedListener	selection-changed-listener
SelectionDragger	selection-dragger
SelectionNodeEvent	selection-node-event
SelectionOnMessageSend	selection-on-message-send
SelectorCompletionItem	selector-completion-item
SelectorImpl	selector-impl
SelectorInfo	selector-info
SelfVariable	self-variable
SenderGetterSetter	sender-getter-setter
SequenceImpl	sequence-impl
SequencedEvent	sequenced-event
SerialArray	serial-array
SerialException	serial-exception
SerializableDateTimeFormat	serializable-date-time-format
SerializingTransport	serializing-transport
ServantObject	servant-object
ServerComparator	server-comparator
ServerCompilerScheduler	server-compiler-scheduler
ServerHostNameAndTimeFilter	server-host-name-and-time-filter
ServerManager	server-manager
ServerMessages	server-messages
ServerMetaData	server-meta-data
ServerStatusTracker	server-status-tracker
ServerTableEntry	server-table-entry
ServerType	server-type
ServerViewFactory	server-view-factory
ServiceInterceptor	service-interceptor
ServicesChildren	services-children
Servlet	servlet
ServletAnnotationMappingUtils	servlet-annotation-mapping-utils
ServletContextAdaptor	servlet-context-adaptor
ServletContextEvent	servlet-context-event
ServletContextTreeLogger	servlet-context-tree-logger
ServletPortletPreferences	servlet-portlet-preferences
SessionExample	session-example
SessionException	session-exception
SessionIDMessage	session-id-message
SessionObject	session-object
SessiondConnection	sessiond-connection
SessionsComboBoxListener	sessions-combo-box-listener
SetAttributeColumnWidthActor	set-attribute-column-width-actor
SetBugDatabaseInfo	set-bug-database-info
SetCharacterEncodingFilter	set-character-encoding-filter
SetDrawRectANY	set-draw-rect-any
SetOverrideTypeHelper	set-override-type-helper
SetSimpleValueTypeSecondPass	set-simple-value-type-second-pass
SettingsAction	settings-action
SettingsJDOMWriter	settings-jdom-writer
SettingsUtil	settings-util
SetupRenderPhase	setup-render-phase
Severity	severity
SftpConfiguration	sftp-configuration
SftpUserInfo	sftp-user-info
ShaModule	sha-module
ShallowPreorderInterator	shallow-preorder-interator
SharabilityFilter	sharability-filter
ShareResourceFileImpl	share-resource-file-impl
ShareableInputSource	shareable-input-source
SharedDocumentAdapter	shared-document-adapter
SharedLocation	shared-location
ShellLine	shell-line
ShellUserPasswordHandler	shell-user-password-handler
ShiftTabAction	shift-tab-action
ShortcutComparator	short-cut-comparator
ShorthandBackgroundParser	shorthand-background-parser
ShowAllAttributesAction	show-all-attributes-action
ShowAllChangesAction	show-all-changes-action
ShowCRCTask	show-crc-task
ShowClasspathDepsAction	show-classpath-deps-action
ShowConsoleAction	show-console-action
ShowFailures	show-failures
ShowInHandler	show-in-handler
ShowSupportedBreakpointsAction	show-supported-breakpoints-action
ShowTestHierarchyAction	show-test-hierarchy-action
ShowWhitespaceCharactersAction	show-whitespace-characters-action
SignatureReader	signature-reader
SignatureWriter	signature-writer
Signed64Marshaller	signed64-marshaller
SignedEncryptedSupportingTokensFactory	signed-encrypted-supporting-tokens-factory
SignedMutableBigInteger	signed-mutable-big-integer
SignedObject	signed-object
SignedSelector	signed-selector
SimilarityQueries	similarity-queries
SimpleAnalyzer	simple-analyzer
SimpleB	simple-b
SimpleBlob	simple-blob
SimpleCSItemDetails	simple-cs-item-details
SimpleConnectorStartupEnvironment	simple-connector-startup-environment
SimpleConverter	simple-converter
SimpleDetailsMessages	simple-details-messages
SimpleDocument	simple-document
SimpleDriverDataSourceFactory	simple-driver-data-source-factory
SimpleFragmenter	simple-fragmenter
SimpleFragmentsBuilder	simple-fragments-builder
SimpleGroovyDoc	simple-groovy-doc
SimpleNameClass	simple-name-class
SimpleNetworkServerSample	simple-network-server-sample
SimplePayloadDecoder	simple-payload-decoder
SimplePluginInstaller	simple-plugin-installer
SimplePreparedStatementCreator	simple-prepared-statement-creator
SimpleRPCServiceImpl	simple-rpc-service-impl
SimpleReadWriteEJBLock	simple-read-write-ejb-lock
SimpleRemapper	simple-remapper
SimpleSampler	simple-sampler
SimpleSearchInfo	simple-search-info
SimpleServer	simple-server
SimpleXMLParserDocumentNodeImpl	simple-xml-parser-document-node-impl
SimpleXMLSchema	simple-xml-schema
SimulatedXATransactionDemarcationStrategy	simulated-xa-transaction-demarcation-strategy
SinceTagResolution	since-tag-resolution
SingleEntryRegistry	single-entry-registry
SingleMatchScorer	single-match-scorer
SingleTypePropertyInfoImpl	single-type-property-info-impl
SingletonBlob	singleton-blob
SiteArchive	site-archive
SiteBookmark	site-bookmark
SiteContentConsumer	site-content-consumer
SiteInputContext	site-input-context
SiteTypeFactory	site-type-factory
SitesImportExport	sites-import-export
SizeValidatorForArrayOfChar	size-validator-for-array-of-char
Sj	sj
SkeletonViewerSorter	skeleton-viewer-sorter
SlaveHandlerService	slave-handler-service
SliderListener	slider-listener
SnapshotActionsHandler	snapshot-actions-handler
SnapshotManager	snapshot-manager
SnapshotTokenList	snapshot-token-list
SnippetOpenOnSelectionAction	snippet-open-on-selection-action
SnippetPanel	snippet-panel
SnmpBadSecurityLevelException	snmp-bad-security-level-exception
SnmpEntryOid	snmp-entry-oid
SnmpLoadedClassData	snmp-loaded-class-data
SnmpStatusException	snmp-status-exception
SnmpString	snmp-string
SocketOptsImpl	socket-opts-impl
SoftLocationXRefs	soft-location-x-refs
SolarisPrivilegesSupportProvider	solaris-privileges-support-provider
SolicitResponseOperationImpl	solicit-response-operation-impl
SortBuffer	sort-buffer
SortByCategoryAction	sort-by-category-action
SortElementsOperation	sort-elements-operation
SortNodes	sort-nodes
SourceAnalyzer	source-analyzer
SourceFileScanner	source-file-scanner
SourceFilteringListener	source-filtering-listener
SourceFinder	source-finder
SourceFoldersWizardPanel	source-folders-wizard-panel
SourceLevelChecker	source-level-checker
SourceLocationManager	source-location-manager
SourceMethodWithChildrenInfo	source-method-with-children-info
SourcePRI	source-pri
SourceTaskFactoryManager	source-task-factory-manager
SourceTypeBinding	source-type-binding
SourceUtils	source-utils
SourceView	source-view
SpacesCategorySupport	spaces-category-support
SpanClipRenderer	span-clip-renderer
SpecialSearchGroup	special-search-group
SpeedManagerFactory	speedmanager-factory
SpeedTestSetLimitPanel	speed-test-set-limit-panel
SpeedTokenDispenserPrioritised	speed-token-dispenser-prioritised
SpiderChartDesignEvaluator	spider-chart-design-evaluator
SpiderPlotXmlFactory	spider-plot-xml-factory
SpinnerMaximumProperty	spinner-maximum-property
SplashRunner	splash-runner
SplitFilter	split-filter
SpreadListEvaluatingException	spread-list-evaluating-exception
SpreadSheetCorner	spread-sheet-corner
SpringConfigModel	spring-config-model
SpringElCompletionProvider	spring-el-completion-provider
SpringIndex	spring-index
SpringResourceLoader	spring-resource-loader
SpringSessionContext	spring-session-context
SpringXMLConfigDataNode	spring-xml-config-data-node
SqlDateConverter	sql-date-converter
SqlFunction	sql-function
StAX2SAXReader	stax-2-sax-reader
StackItem	stack-item
StacktraceOutputListener	stacktrace-output-listener
StandaloneTubeAssembler	standalone-tube-assembler
StandardBarPainter	standard-bar-painter
StandardBooleanQueryNode	standard-boolean-query-node
StandardCategoryURLGenerator	standard-category-url-generator
StandardChartTheme	standard-chart-theme
StandardElementHandler	standard-element-handler
StandardGlyphVector	standard-glyph-vector
StandardJavaBreakpointEditor	standard-java-breakpoint-editor
StandardPieToolTipGenerator	standard-pie-tool-tip-generator
StandardPipeline	standard-pipeline
StandardPointcutParser	standard-point-cut-parser
StandardTickUnitSource	standard-tick-unit-source
StandardXYBarPainter	standard-xy-bar-painter
StartEnd	start-end
StartLevelManager	start-level-manager
StartServerMojo	start-server-mojo
StateResolverUtils	state-resolver-utils
StatelessEjbNode	stateless-ejb-node
StatelessHandleImpl	stateless-handle-impl
StatementCacheInteractor	statement-cache-interactor
StatementUtil	statement-util
StaticFieldExpr	static-field-expr
StaticProxyConfig	static-proxy-config
StaticTextConverter	static-text-converter
StatusAction	status-action
StatusData	status-data
StatusLine	status-line
StaxResult	stax-result
StaxStreamContentHandler	stax-stream-content-handler
StderrWrapper	stderr-wrapper
StepAction	step-action
StepBlockCallBack	step-block-call-back
SteppedIterator	stepped-iterator
StimulusRPC	stimulus-rpc
Stmt_c	stmt-c
StopProcess	stop-process
StopServerCommand	stop-server-command
StopServerThread	stop-server-thread
StrTerm	str-term
StreamBlockCipher	stream-block-cipher
StreamConsoleReader	stream-console-reader
StreamReader	stream-reader
StreamSource	stream-source
StreamTokenizer	stream-tokenizer
StringAppendState	string-append-state
StringBufferResourceStream	string-buffer-resource-stream
StringCutter	string-cutter
StringDecoder	string-decoder
StringLit_c	string-lit-c
StringNamespaceElement	string-namespace-element
StringPrepDataReader	string-prep-data-reader
StringPrettyPrinter	string-pretty-printer
StringPrintWriter	string-print-writer
StringRONodeProp	string-ro-node-prop
StringSelector	string-selector
StringToCharacterConverter	string-to-character-converter
StringVariableSelectionDialog	string-variable-selection-dialog
Strings	strings
Stringz	stringz
StripesELContext	stripes-el-context
StructMember	struct-member
StructureTypeTreeNode	structure-type-tree-node
StrutsCatalog	struts-catalog
StrutsConfigHyperlinkProvider	struts-config-hyperlink-provider
StrutsSpringTestCase	struts-spring-test-case
StubArchiveApiTypeContainer	stub-archive-api-type-container
StyleEditor	style-editor
StylePatternListProperty	style-pattern-list-property
StyledTextEvent	styled-text-event
SubMapEntryIterator	sub-map-entry-iterator
SubMapValueIterator	sub-map-value-iterator
SubSysLcdManager	sub-sys-lcd-manager
SubToolBarManager	sub-tool-bar-manager
SubTreeModelLabelProvider	sub-tree-model-label-provider
SubjectCodeSource	subject-code-source
SubjectPublicKeyInfo	subject-public-key-info
SubmitLinkPage	submit-link-page
SubqueryExpression	subquery-expression
SubscriberSyncInfoCollector	subscriber-sync-info-collector
Subscription	subscription
SubtaskUndoItem	subtask-undo-item
SuffixAction	suffix-action
SuiteCustomizerLibraries	suite-customizer-libraries
SuiteMethodBuilder	suite-method-builder
SunJavah	sun-javah
SunPNGEncoderAdapter	sun-png-encoder-adapter
SunPageSelection	sun-page-selection
SurrugateList	surrugate-list
SuspendTimeoutStatusHandler	suspend-timeout-status-handler
SvnSearchHistorySupport	svn-search-history-support
SwarmCache	swarm-cache
SwingPropertyChangeSupport	swing-property-change-support
SwingTreeViewNodeRenderer	swing-tree-view-node-renderer
SwingUtils	swing-utils
SwitchMemoryBlockAction	switch-memory-block-action
SwitchPointCD	switch-point-cd
SwitchT	switch-t
SymbolSpace	symbol-space
SyncOnNonFinal	sync-on-non-final
SynchronizeModelOperation	synchronize-model-operation
SynchronizeOnClassLiteralNotGetClass	synchronize-on-class-literal-not-get-class
SynchronizePageActionGroup	synchronize-page-action-group
SynchronizedCallable	synchronized-callable
SynchronizedDynamicMethod	synchronized-dynamic-method
SynchronizedList	synchronized-list
SyntaxForms	syntax-forms
SynthCheckBoxUI	synth-check-box-ui
SynthComboBoxRenderer	synth-combo-box-renderer
SynthMenuItemUI	synth-menu-item-ui
SyntheticInstantiationAdvisor	synthetic-instantiation-advisor
SystemIdentity	system-identity
SystemMenuMovePane	system-menu-move-pane
SystemPropertiesSymbolProvider	system-properties-symbol-provider
SystemPropertyUtils	system-property-utils
T	t
T1	t-1
TCPPortHelper	tcp-port-helper
TCShell	tc-shell
TH	th
TLDNode	tld-node
TM	tm
TR	tr
TRTrackerServerTorrentStatsImpl	tr-tracker-server-torrent-stats-impl
TType	t-type
T_DuplicateEliminator	t-duplicate-eliminator
T_Like	t-like
TabChecklist	tab-check-list
TabLayoutPanel	tab-layout-panel
TabPanel	tab-panel
TabSet	tab-set
TabSrc	tab-src
TabbedNavigation	tabbed-navigation
TabbedPropertyViewer	tabbed-property-viewer
TableCellElementInfo	table-cell-element-info
TableColorSchema	table-color-schema
TableColorSchemaStrategy	table-color-schema-strategy
TableColumnImpl	table-column-impl
TableColumnLayout	table-column-layout
TableContextMenuItemImpl	table-context-menu-item-impl
TableDescription	table-description
TableMetaDataContext	table-meta-data-context
TableModelHandler	table-model-handler
TablePrivilegesNode	table-privilege-snode
TableRemoveRequestMonitor	table-remove-request-monitor
TableRenderingContentProvider	table-rendering-content-provider
TableRowImpl	table-row-impl
TableSubCellImpl	table-sub-cell-impl
TableViewerColumn	table-viewer-column
TagEntry	tag-entry
TagEntryImpl	tag-entry-impl
TagHandlerIterator	tag-handler-iterator
TagLibraryValidator	tag-library-validator
TagSupport	tag-support
TagUtils	tag-utils
TaggedComponentHolder	tagged-component-holder
TagletManager	taglet-manager
TakeHeapDumpCommand	take-heap-dump-command
TarEntry	tar-entry
TarFileExporter	tar-file-exporter
TarScanner	tar-scanner
TargetChangedListener	target-changed-listener
TargetEnumeratingVisitor	target-enumerating-visitor
TargetModuleInfo	target-module-info
TargetOSArchVariableResolver	target-os-arch-variable-resolver
TargetOriginating	target-originating
TaskConfigurator	task-configurator
TaskDependencyCollectionImpl	task-dependency-collection-impl
TaskFormula	task-formula
TaskGroupRenderer	task-group-renderer
TaskHierarchyManagerImpl	task-hierarchy-manager-impl
TaskSaver	task-saver
TaskStructureImpl	task-structure-impl
TaskTreeTableCellRenderer	task-tree-table-cell-renderer
TeamOperation	team-operation
TeiClassRenameElement	tei-class-rename-element
TelemetryOverviewAction	telemetry-overview-action
TellNextTellerAction	tell-next-teller-action
TempTableInfo	temp-table-info
TemplateActionListener	template-action-listener
TemplateAttributesProviderImpl	template-attributes-provider-impl
TemplateBuffer	template-buffer
TemplateInformationControlCreator	template-information-control-creator
TemplateSubPatternAssociation	template-sub-pattern-association
TemplateWizardIteratorWrapper	template-wizard-iterator-wrapper
TemplatesReader	templates-reader
TermInfosWriter	term-infos-writer
TermOutputWriter	term-output-writer
TermQueryBuilder	term-query-builder
TermScorer	term-scorer
TerminalLocalNativeProcess	terminal-local-native-process
TermsHashConsumer	terms-hash-consumer
TermsHashConsumerPerThread	terms-hash-consumer-per-thread
TestBreakIterator	test-break-iterator
TestClassLoader	test-class-loader
TestClassRunnerForParameters	test-class-runner-for-parameters
TestEnvironment	test-environment
TestErrorHandler	test-error-handler
TestFilter	test-filter
TestGroupTreeNode	test-group-tree-node
TestJTypeDeclaration	test-j-type-declaration
TestORBInitializer1	test-orb-initializer-1
TestORBInitializer2	test-orb-initializer-2
TestProjectCommand	test-project-command
TestRestServicesAction	test-rest-services-action
TestSessionBean	test-session-bean
TextAreaBeanInfo	text-area-bean-info
TextAreaDirective	text-area-directive
TextAreaNotInScrollPaneState	text-area-not-in-scroll-pane-state
TextAreaTransferHandler	text-area-transfer-handler
TextCell	text-cell
TextContentDescriber	text-content-describer
TextEditorSupportFactory	text-editor-support-factory
TextFetcher	text-fetcher
TextFieldFocusListener	text-field-focus-listener
TextFieldNavigationHandler	text-field-navigation-handler
TextFieldProperty	text-field-property
TextFieldTag	text-field-tag
TextFileFilter	text-file-filter
TextFilteredPropertyColumn	text-filtered-property-column
TextImporter	text-importer
TextLabelFactory	text-label-factory
TextLayout	text-layout
TextLexerInputOperation	text-lexer-input-operation
TextMessages	text-messages
TextOutputVisitor	text-output-visitor
TextPageElement	text-page-element
TextProviderFactory	text-provider-factory
TextRegion	text-region
TextStatusContextViewer	text-status-context-viewer
TextStylePreviewPanel	text-style-preview-panel
TextSwitcher	text-switcher
TextSymbol	text-symbol
TextValue	text-value
TextualDiffRefreshTask	textual-diff-refresh-task
ThaiInputMethod	thai-input-method
ThisReference	this-reference
ThreadBreakpoint	thread-breakpoint
ThreadDataTable	thread-data-table
ThreadMapDataQuery	thread-map-data-query
ThreadPoolExecutorAdapter	thread-pool-executor-adapter
ThreadStackVisualizer	thread-stack-visualizer
ThreadState	thread-state
ThreadSummaryCellRenderer	thread-summary-cell-renderer
ThreadedPermutationWorker	threaded-permutation-worker
ThreadedPermutationWorkerFactory	threaded-permutation-worker-factory
ThreadsDataManager	threads-data-manager
Throw_c	throw-c
TimeBase	time-base
TimeComparisons	time-comparisons
TimeEntry	time-entry
TimeFieldChinaExample	time-field-china-example
TimeIntervalDataFilterFactory	time-interval-data-filter-factory
TimePeriodAnchor	time-period-anchor
TimeScaleManager	time-scale-manager
TimeSeriesIndicator	time-series-indicator
TimeType	time-type
TimeUnitText	time-unit-text
TimerBlinkTask	timer-blink-task
TimestampDiscrepancyService	timestamp-discrepancy-service
TitleRegionLayout	title-region-layout
TldMove	tld-move
ToStringCommandSink	to-string-command-sink
TocInputContext	toc-input-context
TodoFiltersContributionParameters	todo-filters-contribution-parameters
ToggleLeftToolbarAction	toggle-left-toolbar-action
ToggleProperty	toggle-property
TogglesGoEastAction	toggles-go-east-action
TokenContext	token-context
TokenRewriteStream	token-rewrite-stream
TokenStreamIOException	token-stream-io-exception
TokenStreamRetryException	token-stream-retry-exception
TokenTypeFactory	token-type-factory
Tomcat6IntegrationProvider	tomcat6-integration-provider
TomcatTargetNode	tomcat-target-node
ToolBarEastState	tool-bar-east-state
ToolBarUI	tool-bar-ui
ToolBarWestState	tool-bar-west-state
ToolTipMessageProperty	tool-tip-message-property
ToolbarGrip	toolbar-grip
ToolchainNodeProvider	tool-chain-node-provider
TopComponentDragSupport	top-component-drag-support
TorrentDownloaderException	torrent-downloader-exception
TorrentLog	torrent-log
TorrentManagerImpl	torrent-manager-impl
TouchpointDataHandler	touchpoint-data-handler
TrackerStatusItem	tracker-status-item
TrailingMiscDispatcher	trailing-misc-dispatcher
Transaction	transaction
TransactionManagerImplGBean	transaction-manager-impl-g-bean
TransactionTable	transaction-table
TransactionType	transaction-type
TransducedAccessor	transduced-accessor
TransducedAccessor_field_Boolean	transduced-accessor-field-boolean
TransferFilesChangeSupport	transfer-files-change-support
TransformInputOutput	transform-input-output
TransformUtil	transform-util
TransformerHandlerFactory	transformer-handler-factory
TransientNameService	transient-name-service
TranslateActionFactory	translate-action-factory
TransparentContainer	transparent-container
TrapReceiver	trap-receiver
TreeDirective	tree-directive
TreeElementFactoryImpl	tree-element-factory-impl
TreeHierarchyLayoutProblemsDecorator	tree-hierarchy-layout-problems-decorator
TreeListModel	tree-list-model
TreeListUI	tree-list-ui
TreeListenerCollection	tree-listener-collection
TreeModelContentProvider	tree-model-content-provider
TreeModelViewer	tree-model-viewer
TreeNamespace	tree-namespace
TreeNodeIterator	tree-node-iterator
TreeNodeTag	tree-node-tag
TreeParentNode	tree-parent-node
TreeTableCellEditorImpl	tree-table-cell-editor-impl
TrimFunction	trim-function
TripleKeyHashMap	triple-key-hash-map
TrivialGanttExample	trivial-gantt-example
Trouble	trouble
TrustedCertEntry	trusted-cert-entry
TrustedLibrariesSyntaxException	trusted-libraries-syntax-exception
Turbo	turbo
TwoPaneElementSelector	two-pane-element-selector
TypeCategoryDefinition	type-category-definition
TypeCodeImplHelper	type-code-impl-helper
TypeContentProposal	type-content-proposal
TypeInfoWriter	type-info-writer
TypeOccurrenceCollector	type-occurrence-collector
TypeProductionFilter	type-production-filter
TypeSetIntersection	type-set-intersection
TypeTightener	type-tightener
TypeVariableHighlighting	type-variable-highlighting
TypedAncestorIterator	typed-ancestor-iterator
TypedNamespaceIterator	typed-namespace-iterator
TypedStringValue	typed-string-value
TypedValue	typed-value
UCDecoder	uc-decoder
UCEncoder	uc-encoder
UF	uf
UI	ui
UIDebugGenerator	ui-debug-generator
UIEventImpl	ui-event-impl
UIListenerLogging	ui-listener-logging
UIMagnetHandler	ui-magnet-handler
UITagExample	ui-tag-example
UIThread	ui-thread
UL	ul
ULONG_PTR	ulong-ptr
ULongSeqHolder	u-long-seq-holder
UMLActionAsynchronousCheckBox	uml-action-asynchronous-check-box
UMLActionSequenceActionListModel	uml-action-sequence-action-list-model
UMLCallActionOperationComboBox2	uml-call-action-operation-combobox-2
UMLClassDiagram	uml-class-diagram
UMLClassifierInStateTypeComboBoxModel	uml-classifier-instate-type-combo-box-model
UMLClassifierPackageImportsListModel	uml-classifier-package-imports-list-model
UMLCollaborationDiagram	uml-collaboration-diagram
UMLDependencyClientListModel	uml-dependency-client-list-model
UMLModelElementTaggedValueDocument	uml-model-element-tagged-value-document
UMLModelStereotypeListModel	uml-model-stereotype-list-model
UMLMutableLinkedList	uml-mutable-linked-list
UMLOperationRaisedExceptionsListModel	uml-operation-raised-exceptions-list-model
UMLSequenceDiagram	uml-sequence-diagram
UMLStimulusReceiverListModel	uml-stimulus-receiver-list-model
UMLTableCellRenderer	uml-table-cell-renderer
UMLTagDefinitionOwnerComboBoxModel	uml-tag-definition-owner-combo-box-model
UMLTransitionEffectListModel	uml-transition-effect-list-model
UNKNOWN	unknown
UPnPRootDeviceImpl	upnp-root-device-impl
UPnPSSWANIPConnectionImpl	upnp-sswan-ip-connection-impl
URLConfigurator	url-configurator
USD3Provider	usd3-provider
UTF16BTCConverter	utf16-btc-converter
UTTimerImpl	ut-timer-impl
UiBinderGenerator	ui-binder-generator
UnaryOpDerived	unary-op-derived
UnboundedEntryIterator	unbounded-entry-iterator
UnconditionalValueDerefAnalysis	unconditional-value-deref-analysis
Undeploy	undeploy
UndoPosRef	undo-pos-ref
UndoRedoManager	undo-redo-manager
UneditableTableModel	uneditable-table-model
UnicodeUtils	unicode-utils
UnifyFieldAccess	unify-field-access
UninitializedObjectType	uninitialized-object-type
UninstallWizardPage	uninstall-wizard-page
UnionPathExpr	union-path-expr
UniqueValueStore	unique-value-store
UnitDetails	unit-details
UnixBrowserImpl	unix-browser-impl
UnlockKeyHandler	unlock-key-handler
UnmappedAddressException	unmapped-address-exception
UnmarshalCache	unmarshal-cache
UnresolvedNamespaceUID	unresolved-namespace-uid
Unsigned8ResultConverter	unsigned-8-result-converter
UnsignedAccessViolationException	unsigned-access-violation-exception
UnsupportedLookAndFeelException	unsupported-look-and-feel-exception
UnsyncBufferedOutputStream	unsync-buffered-output-stream
UpdatableNode	updatable-node
UpdateActionsRequest	update-actions-request
UpdateActiveExtensionsOperation	update-active-extensions-operation
UpdateFoldsRequest	update-folds-request
UpdateModel	update-model
UpdateResultSet	update-result-set
UpdateSchedulerMessages	update-scheduler-messages
UpdateTimestampsCache	update-timestamps-cache
UpdateUnitProvider	update-unit-provider
UpdatedMethodBinding	updated-method-binding
UrandomSource	urandom-source
UrlAction	url-action
UrlBase64	url-base64
UrlBasedRemoteAccessor	url-based-remote-accessor
UrlBinding	url-binding
UrlBindingConflictException	url-binding-conflict-exception
UrlSection	url-section
UrtDefaultPolicy	urt-default-policy
UseObjectEquals	use-object-equals
UseSupertypeAction	use-supertype-action
UserActionListener	user-action-listener
UserCatalog	user-catalog
UserConfigurationTemplatesProvider	user-configuration-templates-provider
UserProfileReference	user-profile-reference
UserReader	user-reader
UserRoleAuthorizationInterceptor	user-role-authorization-interceptor
UsernameAuthPasswordDerivedKeys	username-auth-password-derived-keys
Ushort565Rgb	u-short565-rgb
Utf8Entry	utf8-entry
UtilEvalError	util-eval-error
UtilitiesCompositeActionMap	utilities-composite-action-map
V9SpecialLoadDecoder	v9-special-load-decoder
VCSKenaiAccessor	vcs-kenai-accessor
VDFDeploymentBuilder	vdf-deployment-builder
VFSResource	vfs-resource
VM	vm
VMDPinWidget	vmd-pin-widget
VMInstallWizard	vm-install-wizard
VMOutOfMemoryException	vm-out-of-memory-exception
VSplitter	v-splitter
VTIResultSet	vti-result-set
ValidRequestsResponse	valid-requests-response
ValidatingThread	validating-thread
ValidationEventImpl	validation-event-impl
ValidationStatusObservableValue	validation-status-observable-value
ValidationStatusProviderValidationStatusProperty	validation-status-provider-validation-status-property
ValidatorActionInvocation	validator-action-invocation
ValidityException	validity-exception
ValueAction	value-action
ValueChangingEvent	value-changing-event
ValueComboBoxEditor	value-combo-box-editor
ValueHandlerImpl_1_3_1	value-handler-impl-1-3-1
ValueImplementation	value-implementation
ValueMarker	value-marker
ValueMarksProvider	value-marks-provider
ValueSequence	value-sequence
ValueSetterFactory	value-setter-factory
VarListPat	var-list-pat
VariableColumnFactoryAdapter	variable-column-factory-adapter
VariableDeclarationStatement	variable-declaration-statement
VariableFinderVisitor	variable-finder-visitor
VariableGridLayout	variable-grid-layout
VariablesInfo	variables-info
VariablesSupport	variables-support
VectorEnumerator	vector-enumerator
VelocityWriter	velocity-writer
VendorBean	vendor-bean
VersionSupport	version-support
VersionTag	version-tag
VersionedObjectInterceptorFactory	versioned-object-interceptor-factory
VideoTest	video-test
ViewStackTrimToolBar	view-stack-trim-tool-bar
ViewStateEvent	view-state-event
ViewSwitcher	view-switcher
ViewTabLayoutModel	view-tab-layout-model
ViewTabLayoutModel2	view-tab-layout-model-2
ViewTooltips	view-tooltips
ViewTypeAction	view-type-action
ViewportGuard	viewport-guard
ViewportLayout	viewport-layout
VisibilityControlUtil	visibility-control-util
VisibleDependencies	visible-dependencies
VisitHeap	visit-heap
VisualSQLEditor	visual-sql-editor
VisualsForTree	visuals-for-tree
VmEvent	vm-event
Vset	vset
W	w
W3CEndpointReference	w3c-endpoint-reference
WCharSeqHelper	w-char-seq-helper
WCustomCursor	w-custom-cursor
WGLSurfaceData	wgl-surface-data
WIExplorerBrowserAuthenticator	wi-explorer-browser-authenticator
WL	wl
WLClassLoader	wl-class-loader
WMLRefreshElementImpl	wml-refresh-element-impl
WMLTimerElementImpl	wml-timer-element-impl
WMenuBarPeer	w-menu-bar-peer
WNetscapePluginContext	w-netscape-plugin-context
WSDLGeneratorExtension	wsdl-generator-extension
WSHttpHandler	ws-http-handler
WSITRefactoringPlugin	wsit-refactoring-plugin
WaitScreenFailureCommandCD	wait-screen-failure-command-cd
WatchEditPreferencePage	watch-edit-preference-page
WatchExpressionFactoryTester	watch-expression-factory-tester
WatchersInformation	watchers-information
WatchpointDetailPane	watchpoint-detail-pane
WebApp	web-app
WebBrowserView	web-browser-view
WebLocationsPanel	web-locations-panel
WebLogic81DatabaseConverter	web-logic81-database-converter
WebMarkupContainer	web-markup-container
WebProjectCustomizerRun	web-project-customizer-run
WebServiceWrapperGenerator	web-service-wrapper-generator
WebserviceDescriptionImpl	web-service-description-impl
WebservicesImpl	web-services-impl
Weight	weight
WelcomeDialog	welcome-dialog
WelcomeEditor	welcome-editor
WeldInjector	weld-injector
WhitespaceRule	whitespace-rule
WhoIncludesAction	who-includes-action
WicketServlet	wicket-servlet
WidgetTabItem	widget-tab-item
WildcardRef	wild-card-ref
WinICOFileFormat	win-ico-file-format
WindbgX86ThreadContext	windbg-x86-thread-context
Window	window
WindowClosingAdapter	window-closing-adapter
WindowPropertyGetter	window-property-getter
WindowsArrowButton	windows-arrow-button
WindowsPreferences	windows-preferences
WindowsRegistry	windows-registry
WizardDataTransferPage	wizard-data-transfer-page
WizardFileSystemResourceImportPage1	wizard-file-system-resource-import-page-1
WizardValidationException	wizard-validation-exception
WordMatchNextAction	word-match-next-action
WorkHorseForCollatorDatatypes	work-horse-for-collator-datatypes
WorkbenchBrowserSupport	workbench-browser-support
WorkbenchMarkerResolution	workbench-marker-resolution
WorkbenchResource	workbench-resource
WorkingSetConfigurationBlock	working-set-configuration-block
WorkingSetMenuContributionItem	working-set-menu-contribution-item
WorkingSetPaster	working-set-paster
WorkingSetTypePage	working-set-type-page
WorkspaceBundleFragmentModel	workspace-bundle-fragment-model
WrapLine	wrap-line
WritableList	writable-list
WriteResult	write-result
WriterAppender	writer-appender
WrongTransactionHelper	wrong-transaction-helper
WsdlFileFilter	wsdl-file-filter
WsdlPortTextFieldEditorModel	wsdl-port-text-field-editor-model
WsdlService	wsdl-service
Wss11Impl	wss11-impl
WssKerberosV5ApReqToken11Factory	wss-kerberos-v5-ap-req-token11-factory
WssSamlV10Token11Impl	wss-saml-v10-token11-impl
WssX509Pkcs7Token10Factory	wss-x509-pkcs7-token10-factory
X	x
X11CNS11643	x11-cns11643
X11DragSourceContextPeer	x11-drag-source-context-peer
X11Selection	x11-selection
X86RegisterDirectAddress	x86-register-direct-address
X86SegmentRegister	x86-segment-register
X9Curve	x9-curve
XAConnectionPropertyMetaData	xa-connection-property-meta-data
XArrayDataViewer	x-array-data-viewer
XCopy	x-copy
XDUDiffFinder	xdu-diff-finder
XEmbedServer	x-embed-server
XFramePeer	x-frame-peer
XIncludeAwareParserConfiguration	x-include-aware-parser-configuration
XIntPool	x-int-pool
XMLCodec	xml-codec
XMLCompletionProposal	xml-completion-proposal
XMLDTDProcessor	xml-dtd-processor
XMLErrorHandler	xml-error-handler
XMLFile	xml-file
XMLFileEntry	xml-file-entry
XMLGrammarBuilder	xml-grammar-builder
XMLHelper	xml-helper
XMLInputFactory	xml-input-factory
XMLLocatorWrapper	xml-locator-wrapper
XMLNode	xml-node
XMLSchema	xml-schema
XMLStringFactoryDefault	xml-string-factory-default
XMLStringPartitionScanner	xml-string-partition-scanner
XMLSyntaxColorTab	xml-syntax-color-tab
XMLTreeRepresentation	xml-tree-representation
XMLUtils	xml-utils
XML_DOM_SAX_FI	xml-dom-sax-fi
XORComposite	xor-composite
XPDLUValue	xpdlu-value
XPLAINStatementDescriptor	xplain-statement-descriptor
XPathImpl	x-path-impl
XPropertyCache	x-property-cache
XQException	xq-exception
XQueryTree	x-query-tree
XResources_cy	x-resources-cy
XResources_de	x-resources-de
XResources_el	x-resources-el
XResources_en	x-resources-en
XResources_es	x-resources-es
XResources_fr	x-resources-fr
XResources_he	x-resources-he
XResources_hy	x-resources-hy
XResources_it	x-resources-it
XResources_ka	x-resources-ka
XResources_ko	x-resources-ko
XResources_sv	x-resources-sv
XSGroupDecl	xs-group-decl
XSLTErrorResources_ca	xslt-error-resources-ca
XSLTErrorResources_cs	xslt-error-resources-cs
XSLTErrorResources_de	xslt-error-resources-de
XSLTErrorResources_en	xslt-error-resources-en
XSLTErrorResources_es	xslt-error-resources-es
XSLTErrorResources_fr	xslt-error-resources-fr
XSLTErrorResources_hu	xslt-error-resources-hu
XSLTErrorResources_it	xslt-error-resources-it
XSLTErrorResources_ja	xslt-errorresources-ja
XSLTErrorResources_ko	xslt-error-resources-ko
XSLTErrorResources_pl	xslt-error-resources-pl
XSLTErrorResources_ru	xslt-error-resources-ru
XSLTErrorResources_sk	xslt-error-resources-sk
XSLTErrorResources_sl	xslt-error-resources-sl
XSLTErrorResources_sv	xslt-error-resources-sv
XSLTErrorResources_tr	xslt-error-resources-tr
XSLTErrorResources_zh	xslt-error-resources-zh
XSLTServletWithParams	xslt-servlet-with-params
XSNamedMap4Types	xs-named-map-4-types
XSParticleDecl	xs-particle-decl
XTranslateCoordinates	x-translate-coordinates
XWorkConverter	x-work-converter
XWorkException	x-work-exception
XWorkMapPropertyAccessor	x-work-map-property-accessor
XYChartHyperlinkProvider	xy-chart-hyperlink-provider
XmlConstants	xml-constants
XmlErrorHandler	xml-error-handler
XmlFileHandler	xml-file-handler
XmlReaderContentHandler	xml-reader-content-handler
XmlssCellStyle	xmlss-cell-style
XsltTransformer	xslt-transformer
Y	y
Z	z
ZargoFilePersister	zargo-file-persister
ZendOptionsPanel	zend-options-panel
ZipBundleEntry	zip-bundle-entry
ZoomManager	zoom-manager
ZoomSliderButton	zoom-slider-button
_InitialNameServiceStub	initial-name-service-stub
_ORBProxyStub	orb-proxy-stub
_ObjectArray	object-array
apcompare	ap-compare
buddyConnection	buddy-connection
cStringIO	c-string-io
cairo_font_extents_t	cairo-font-extents-t
comprehension	comprehension
comprehensionDerived	comprehension-derived
connectionEntry	connection-entry
dnsURLContext	dns-url-context
elementDeclBody	element-decl-body
ersSet	ers-set
gUnitAdapter	g-unit-adapter
gc	gc
helper	helper
ij	ij
ijException	ij-exception
in	in
java_awt_MenuBar_PersistenceDelegate	java-awt-menu-bar-persistence-delegate
java_util_List_PersistenceDelegate	java-util-list-persistence-delegate
ldapURLContextFactory	ldap-url-context-factory
licenceDetails	licence-details
motif_de	motif-de
motif_es	motif-es
motif_fr	motif-fr
motif_it	motif-it
motif_ja	motif-ja
motif_ko	motif-ko
motif_sv	motif-sv
mtTestCase	mt-test-case
nodesDepthComparator	nodes-depth-comparator
nsIHelperAppLauncherDialog	ns-i-helper-app-launcher-dialog
nsIScriptSecurityManager_1_9_1	ns-i-script-security-manager-1-9-1
operator	operator
os	os
pageDetails	page-details
pingSource	ping-source
production_part	production-part
proxyStateV5MethodNumber	proxy-state-v5-method-number
randomFile	random-file
reduce_action	reduce-action
tp	tp
ucnhash	ucnhash
update	update
utilMain	util-main
valueIterator	value-iterator
