APR_STATUS_IS_ENOSTAT	apr-status-is-enostat
B	b
Ch	ch
D_ENCRYPT	d-encrypt
Do	do
ERROR_SERVLET_NO_PORT_SPECIFIED	error-servlet-no-port-specified
F	f
F1	f-1
F2	f-2
F3	f-3
F4	f-4
FAILED_TO_PARSE	failed-to-parse
FF	ff
FillPath	fill-path
G	g
GE	ge
GG	gg
GT	gt
GetEnabled	get-enabled
GetGUIThreadInfo	get-gui-thread-info
GetName	get-name
H	h
HH	hh
ID	id
II	ii
INVALID_WSDL_URL	invalid-wsdl-url
If	if
IsRebootNecessary	is-reboot-necessary
J	j
JS_EvaluateUCScriptForPrincipals	js-evaluate-uc-script-for-principals
K	k
KD	kd
L	l
LA	la
LB	lb
LE	le
LT	lt
MinPt	min-pt
MoveFromSet	move-from-set
N	n
NON_ANONYMOUS_RESPONSE_ONEWAY	non-anonymous-response-oneway
NULL_EPR	null-epr
OK	ok
OR	or
OnRunTest	on-run-test
Or	or
PARSING_INVALID_WSDL_ELEMENT	parsing-invalid-wsdl-element
PBinitialize	pb-initialize
PC	pc
PI	pi
PO	po
ParseExpressionSegment	parse-expression-segment
ParseUsing	parse-using
RL	rl
RUNTIME_MODELER_PORTNAME_SERVICENAME_NAMESPACE_MISMATCH	runtime-modeler-portname-servicename-namespace-mismatch
S	s
SQLBindColAtExec	sql-bind-col-at-exec
SQLGetDataBinary	sql-get-data-binary
ScalarField_new	scalar-field-new
SetWindowRgn	set-window-rgn
TRACE_SERVLET_REQUEST_FOR_PORT_NAMED	trace-servlet-request-for-port-named
U	u
VALIDATION_INVALID_ATTRIBUTE_VALUE	validation-invalid-attribute-value
VARBINARY	var-binary
WSIMPORT_USAGE_EXTENSIONS	wsimport-usage-extensions
WindowsRegSetValueEx1	windows-reg-set-value-ex1
XConvertCase	x-convert-case
XDefaultVisual	x-default-visual
XGetDefault	x-get-default
XMoveWindow	x-move-window
XQueryTree	x-query-tree
XSetCopyMode	x-set-copy-mode
_PANGO_PIXELS	pango-pixels
_SoupMessage_request_body	soup-message-request-body
__coerce__	coerce
__rand__	rand
__valueOf	value-of
_atk_object_factory_create_accessible	atk-object-factory-create-accessible
_b	b
_basic_lshift	basic-lshift
_cairo_matrix_multiply	cairo-matrix-multiply
_cairo_pattern_set_matrix	cairo-pattern-set-matrix
_canonPath	canon-path
_dispose	dispose
_dlopen	dl-open
_dlsym	dl-sym
_gdk_colormap_query_color	gdk-colormap-query-color
_gdk_pango_layout_get_clip_region	gdk-pango-layout-get-clip-region
_gdk_window_set_decorations	 gdk-window-set-decorations
_gnome_vfs_get_registered_mime_types	gnome-vfs-get-registered-mime-types
_gtk_editable_copy_clipboard	gtk-editable-copy-clipboard
_gtk_expander_set_label	gtk-expander-set-label
_gtk_file_filter_set_name	gtk-file-filter-set-name
_gtk_image_set_from_pixmap	gtk-image-set-from-pixmap
_gtk_paint_vline	gtk-paint-vline
_gtk_paper_size_free	gtk-paper-size-free
_gtk_print_job_new	gtk-print-job-new
_gtk_print_settings_set_page_ranges	gtk-print-settings-set-page-ranges
_gtk_status_icon_set_from_pixbuf	gtk-status-icon-set-from-pixbuf
_h	h
_i	i
_ixor	i-xor
_jcallexc	j-call-exc
_loadClass	load-class
_lreturn	l-return
_p	p
_paintShadow	paint-shadow
_pango_attr_font_desc_new	pango-attr-font-desc-new
_promptForUserInteractive	prompt-for-user-interactive
_r	r
_reconfigure	reconfigure
_rshift	rshift
_runMLABTest	run-mlab-test
_s	s
_setHorizontalOffset	set-horizontal-offset
_set_delegate	set-delegate
_t	t
a	a
a2	a-2
a_bind_nns	a-bind-nns
aboutToCompile	about-to-compile
absoluteOrder	absolute-order
ac	ac
acceptPath	accept-path
acceptTCRef	accept-tc-ref
accessDisplayDuringStartup	access-display-during-startup
accessFirstElement	access-first-element
accessOriginalValue	access-original-value
accumulate	accumulate
acquirePipeForCurrentThread	acquire-pipe-for-current-thread
activateActionBars	activate-action-bars
activateContentAssist	activate-content-assist
activateMode	activate-mode
adaptSelf	adapt-self
addASTChild	add-ast-child
addAccel	add-accel
addAcceptButtonMouseListener	add-accept-button-mouse-listener
addAfterMethod	add-after-method
addAllGraphElts	add-all-graph-elts
addAllToList	add-all-to-list
addArchives	add-archives
addAttributeWithBuiltInAlgorithmData	add-attribute-with-built-in-algorithm-data
addAuditSecondaryTables	add-audit-secondary-tables
addAuditingOverrides	add-auditing-overrides
addBaseBarcode4jRules	add-base-barcode4j-rules
addBeanFactoryPostProcessor	add-bean-factory-post-processor
addBlockTag	add-block-tag
addBooleanAttributeValueProposals	add-boolean-attribute-value-proposals
addBranchCoverage	add-branch-coverage
addBundleToState	add-bundle-to-state
addChildToTree	add-child-to-tree
addClassPrefixes	add-class-prefixes
addClient	add-client
addColumnModelListener	add-column-model-listener
addCompatibleContextType	add-compatible-context-type
addCompileModels	add-compile-models
addContainerRuntimeOption	add-container-runtime-option
addCssFiles	add-css-files
addDefaultFiltersGBeans	add-default-filters-g-beans
addDependentTypeToContext	add-dependent-type-to-context
addDeploymentLocation	add-deployment-location
addDirectoryParameter2	add-directory-parameter2
addDiscoverer	add-discoverer
addEndOfUnbreakableSequence	add-end-of-unbreakable-sequence
addEnumCompareTo	add-enum-compare-to
addEnumNameField	add-enum-name-field
addExceptionMarker	add-exception-marker
addExport	add-export
addExportPackages	add-export-packages
addExtensionPointSplashExtension	add-extension-point-splash-extension
addExternalReferences	add-external-references
addFLoad	add-f-load
addFileBufferMapping	add-file-buffer-mapping
addFileNameControls	add-file-name-controls
addFileSaved	add-file-saved
addFilterReader	add-filter-reader
addForeignKeyConstraint	add-foreign-key-constraint
addGroupPrincipal	add-group-principal
addHierarchyFilter	add-hierarchy-filter
addIdentifiers	add-identifiers
addImportedResource	add-imported-resource
addIncludedTemplate	add-included-template
addInputBufferListener	add-input-buffer-listener
addJarButtonActionPerformed	add-jar-button-action-performed
addKeyName	add-key-name
addLightweightRequest	add-lightweight-request
addLinePart	add-line-part
addManagedBeanToFacesConfig	add-managed-bean-to-faces-config
addManifestToken	add-manifest-token
addMenuDragMouseListener	add-menu-drag-mouse-listener
addMethodSuffix	add-method-suffix
addModificationListener	add-modification-listener
addModuleToApplication	add-module-to-application
addMultipleFiles	add-multiple-files
addNCalls	add-n-calls
addNatureToProject	add-nature-to-project
addNewCollection	add-new-collection
addNewEntry	add-new-entry
addNodeChildrenToQueue	add-node-children-to-queue
addNonPrimaryTopic	add-non-primary-topic
addObjectUsing	add-object-using
addOrphan	add-orphan
addOuterDeclarationsForLocalType	add-outer-declarations-for-local-type
addOverrideOfSuperclassMethod	add-override-of-superclass-method
addPackageRequirement	add-package-requirement
addPageIdentityDataProvider	add-page-identity-data-provider
addPanelsForModel	add-panels-for-model
addParameterMissmatchProposals	add-parameter-missmatch-proposals
addPluginRoots	add-plugin-roots
addPostClass	add-post-class
addProjectNamePage	add-project-namepage
addReplaceEdits	add-replace-edits
addReportSet	add-report-set
addRequestListener	add-request-listener
addResourceChunk	add-resource-chunk
addRowHeader	add-row-header
addSchemaType	add-schema-type
addScrapImage	add-scrap-image
addSelectionListener	add-selection-listener
addServiceTag	add-service-tag
addSimilarVariableProposals	add-similar-variable-proposals
addSlide	add-slide
addSourcesInPackage	add-sources-in-package
addStringParameter2	add-string-parameter2
addStringVariable	add-string-variable
addStyleSheet	add-style-sheet
addSubstitutionGroup	add-substitution-group
addSwitch	add-switch
addTabPage	add-tab-page
addTableCase	add-table-case
addTargetClass	add-target-class
addTemplateRules	add-template-rules
addTimestampButtonActionListener	add-timestamp-button-action-listener
addTitledBorder	add-titled-border
addToCleanupThreadLoadedResourceList	add-to-cleanup-thread-loaded-resource-list
addToPool	add-to-pool
addToWorkingSets	add-to-working-sets
addTransform	add-transform
addTypeDependDataLoad	add-type-depend-data-load
addTypeOfNamedClass	add-type-of-named-class
addVariableNameAccess	add-variable-name-access
addWindowManager	add-window-manager
additionalArgs	additional-args
addressOfInterpreterFrameExpressionStack	address-of-interpreter-frame-expression-stack
addressSize	address-size
adjustButton	adjust-button
adjustDescendants	adjust-descendants
adjustRegisters	adjust-registers
adjustRelativeTerms	adjust-relative-terms
adjustThreadsCount	adjust-threads-count
affectsView	affects-view
africaCasablanca	africa-casablanca
ajcPreClinitMethod	ajc-pre-clinit-method
alias_method	alias-method
allElement	all-element
allFilesMoving	all-files-moving
allSaved	all-saved
allocChildMethods	alloc-child-methods
allocateNonDynamicColors	allocate-non-dynamic-colors
allocateSlotId	allocate-slot-id
allowEnums	allow-enums
alwaysOnTop	always-on-top
americaCoralHarbour	america-coral-harbour
americaRioBranco	america-rio-branco
analyse	analyse
analyze	analyze
anyFormOpened	any-form-opened
apacheVanillaLogFile	apache-vanilla-log-file
appendArrayTypeSignatureForAnchor	append-array-type-signature-for-anchor
appendAsRegEx	append-as-regex
appendEncoded	append-encoded
appendEncodedSettings	append-encoded-settings
appendIndexColumns	append-index-columns
appendMarkerToBuffer	append-marker-to-buffer
appendParameterSignature	append-parameter-signature
appendSometimesReadOnly	append-sometimes-readonly
applyCacheMode	apply-cache-mode
applyCurrentShape	apply-current-shape
applyIdAttribute	apply-id-attribute
applyStereotype	apply-stereotype
applyValue	apply-value
applyWriteOnlyStereotype	apply-write-only-stereotype
appointmentChanged	appointment-changed
approveLicenseAgreement	approve-license-agreement
areAllElementsChecked	are-all-elements-checked
areAspTagsEnabled	are-asp-tags-enabled
areExceptionsSameAsInitial	are-exceptions-same-as-initial
areOverriddenMethods	are-overridden-methods
areSeriesDisjoint	are-series-disjoint
arrayAsCollection	array-as-collection
arrayComprehension	array-comprehension
arrayKlassOrNull	array-klass-or-null
as	as
asDimension	as-dimension
asExpression	as-expression
asTarFileSet	as-tar-file-set
asTest	as-test
asText	as-text
ascii2binary	ascii-2-binary
assemblePanels	assemble-panels
assertEscapedTableRowCount	assert-escaped-table-row-count
assertResultPage	assert-result-page
assertSingleArgumentClass	assert-single-argument-class
astlist___iter__	astlist-iter
at	at
at_exit	at-exit
atkAction_do_action	atk-action-do-action
attachInitJob	attach-init-job
attachReaderToCatalog	attach-reader-to-catalog
attachTasklistListener	attachtask-list-listener
attachmentFolder	attachment-folder
attr_reader	attr-reader
attributeImage	attribute-image
autocompleteQuotesAfterEqualSign	autocomplete-quotes-after-equal-sign
availableRows	available-rows
avoidingGui	avoiding-gui
b	b
bExportActionPerformed	b-export-action-performed
badHelperWriteMethod	bad-helper-write-method
basicAddChild	basic-add-child
bcsPreDeserializationHook	bcs-pre-deserialization-hook
beforeUnmarshal	before-unmarshal
beginFunctionDeclaration	begin-function-declaration
beginTracking	begin-tracking
bi	bi
bindDoubleCol	bind-double-col
bindInParameterAtExec	bind-in-parameter-at-exec
bindJoin	bind-join
bindParameter	bind-parameter
binding	binding
bindingAttributes	binding-attributes
blockForAvailableThreads	block-for-available-threads
block_data	block-data
bm	bm
boldText	bold-text
br	br
brandAIX	brand-aix
broadcastPreMoveEvent	broadcast-pre-move-event
bsd_p	bsd-p
btRefresh	bt-refresh
btRemoveSrc	bt-remove-src
btRight	bt-right
bufToCell	buf-to-cell
bugFiled	bug-filed
buildAssociationEndRole	build-association-end-role
buildColumnIndexMethodArgs	build-column-index-method-args
buildComponentTemplatesInvalidationEventHub	build-component-templates-invalidation-event-hub
buildDomainPrincipal	build-domain-principal
buildEntityType	build-entity-type
buildFinalState	build-final-state
buildItemList	build-item-list
buildLogMessage	build-log-message
buildMinimalModelList	build-minimal-model-list
buildPathName	build-path-name
buildRootDelta	build-root-delta
buildSummaryFooter	build-summary-footer
buildTemplateParameter	build-template-parameter
buildWSDLDocument	build-wsdl-document
build_Set	build-set
bumpCurrentOffset	bump-current-offset
bundleInstallComplete	bundle-install-complete
by	by
byteToObjectUnsigned	byte-to-object-unsigned
byteToShort	byte-to-short
bytes2Chars	bytes-2-chars
bytesUsed	bytes-used
c	c
cachePackage	cache-package
cairo_get_target	cairo-get-target
cairo_in_stroke	cairo-in-stroke
calcLineBreak	calc-line-break
calcNewPosition	calc-new-position
calcSlot	calc-slot
calculateFinishEstimate	calculate-finish-estimate
calculateHeight	calculate-height
calculateMaximumSize	calculate-maximum-size
calculateMinUpload	calculate-min-upload
calculatePrefixSegmentCount	calculate-prefix-segment-count
calculatePreservedLineIndentation	calculate-preserved-line-indentation
calibrate	calibrate
callAppenders	call-appenders
callTomcatParser	call-tomcat-parser
calledMethodName	called-method-name
canBeRenderedAsArray	can-be-rendered-as-array
canChangePassword	can-change-password
canDragMove	can-drag-move
canFinishEarly	can-finish-early
canHandleMove	can-handle-move
canImplicitlyCall	can-implicitly-call
canLoadAsArrayOffsetLength	can-load-as-array-offset-length
canLoadDBDriver	can-load-db-driver
canOperateOnSelection	can-operate-on-selection
canReport	can-report
canRequestVMDeathEvent	can-request-vm-death-event
canRunEvaluation	can-run-evaluation
canStartHere	can-start-here
cancelTimer	cancel-timer
cantResolveRootPoa	cant-resolve-root-poa
captureStackTrace	capture-stack-trace
cascadeBeforeDelete	cascade-before-delete
case176_line722	case176-line722
case186_line730	case186-line730
case186_line780	case186-line780
case210_line842	case210-line842
case210_line856	case210-line856
case226_line896	case226-line896
case226_line907	case226-line907
case247_line961	case247-line961
case247_line984	case247-line984
case301_line1154	case301-line1154
case461_line1744	case461-line1744
case461_line1760	case461-line1760
case478_line1817	case478-line1817
case478_line1827	case478-line1827
case510_line1972	case510-line1972
cbSkipCountActionPerformed	cb-skip-count-action-performed
cc	cc
cd	cd
cesEnv	ces-env
cesKit	ces-kit
ch	ch
changeContentAssistProcessor	change-content-assist-processor
changeFile	change-file
changeFont	change-font
changeLocks	change-locks
char_selector	char-selector
checkAlignment	check-alignment
checkCanThrow	check-can-throw
checkCancellationFlag	check-cancellation-flag
checkCapability	check-capability
checkCaseInsensitiveName	check-case-insensitive-name
checkChildren	check-children
checkClassNameOverride	check-class-name-override
checkDeactivation	check-deactivation
checkFieldInType	check-field-in-type
checkFolderLogged	check-folder-logged
checkForUpdatableResultSet	check-for-updatable-result-set
checkForeach	check-for-each
checkHashString	check-hash-string
checkIfFormatted	check-if-formatted
checkIfLoading21API	check-if-loading-21api
checkIncompatibleMask1	check-incompatible-mask1
checkIncompatibleMask2	check-incompatible-mask2
checkInstanceof	check-instanceof
checkIntegrityDo	check-integrity-do
checkJVMVersions	check-jvm-versions
checkKeys	check-keys
checkLabel	check-label
checkLinesWidth	check-lines-width
checkLoaded	check-loaded
checkLoader	check-loader
checkMBean	check-mbean
checkMemberClassFlags	check-member-class-flags
checkMethodModifiers	check-method-modifiers
checkMultipleClasses	check-multiple-classes
checkNoWindowFunctions	check-no-window-functions
checkNotSealed	check-not-sealed
checkOptionFlags	check-option-flags
checkPackagesToDoc	check-packages-to-doc
checkPageComplete	check-page-complete
checkProxyClass	check-proxy-class
checkResize	check-resize
checkResponseCode	check-response-code
checkServerHealth	check-server-health
checkStateElement	check-state-element
checkStrategy	check-strategy
checkSuperDisabledOrOutOfMethod	check-super-disabled-or-out-of-method
checkTargetFlags	check-target-flags
checkTestDirectory	check-test-directory
checkTransactionStatus	check-transaction-status
checkView	check-view
checkXAActive	check-xa-active
childlessCopy	childless-copy
childrenToStringArr	children-to-string-arr
chkEndDate_actionPerformed	chk-end-date-action-performed
chooseConfiguration	choose-configuration
chooseFactoryClass	choose-factory-class
ci	ci
clearBugCounts	clear-bug-counts
clearCachedSuspendEvents	clear-cached-suspend-events
clearCcsidSbc	clear-ccsid-sbc
clearDeletedFiles	clear-deleted-files
clearEditors	clear-editors
clearFilteredFiles	clear-filtered-files
clearHeapConglomerateController	clear-heap-conglomerate-controller
clearListeners	clear-listeners
clearNamespace	clear-namespace
clearRulersSelection	clear-rulers-selection
clearTimers	clear-timers
clickOnColumnAction	click-on-column-action
clipTopComboBoxItemStateChanged	clip-top-combo-box-item-state-changed
cloneCachingContents	clone-caching-contents
closeAllChildren	close-all-children
closeAllModels	close-all-models
closeConsumer	close-consumer
closeTagOnLine	close-tag-on-line
closeTarFile	close-tar-file
code_lload	code-lload
coerceBin	coerce-bin
collapseEntries	collapse-entries
collect19	collect19
collectForRefresh	collect-for-refresh
collectPackageFragments	collect-package-fragments
collectSqlStrings	collect-sql-strings
collector	collector
combine	combine
commitFileBuffer	commit-file-buffer
commitFileBufferContent	commit-file-buffer-content
compareBottom	compare-bottom
compareEntity	compare-entity
compareTextIgnoreCase	compare-text-ignore-case
compileArgsCat	compile-args-cat
compileDRegexp	compile-d-regexp
compileOpElementAsgnWithMethod	compile-op-element-asgn-with-method
completeEditing	complete-editing
completeRecord	complete-record
complex___nonzero__	complex-nonzero
component_def_stmt	component-def-stmt
composeCustomCreationCode	compose-custom-creation-code
computeBasePriorities	compute-base-priorities
computeBestOffset	compute-best-offset
computeConstantOperationOR	compute-constant-operation-or
computeFilterValues	compute-filter-values
computeInitializeIn	compute-initialize-in
computeInterfaceHash	compute-interface-hash
computeKnownSubtypes	compute-known-subtypes
computeLineHeight	compute-line-height
computeReferencedBuildOrder	compute-referenced-build-order
computeReplacementString	compute-replacement-string
computeRootNodeProposals	compute-root-node-proposals
computeSaveEnable	compute-save-enable
computeSizePrivate	compute-size-private
computeSizesAfterFlip	compute-sizes-after-flip
configureRedirector	configure-redirector
configureTypes	configure-types
confirmIdentifier	confirm-identifier
conflictingKeys	conflicting-keys
conjunction	conjunction
connectOutbound	connect-outbound
connectTieWrongOrb	connect-tie-wrong-orb
consumeAnnotationTypeDeclarationHeaderName	consume-annotation-type-declaration-header-name
consumeCaseLabel	consume-case-label
consumeEmptyEnumDeclarations	consume-empty-enum-declarations
consumeInterTypeConstructorHeaderName	consume-inter-type-constructor-header-name
consumeLocalType	consume-local-type
containsPositionCategory	contains-position-category
contentNetworkImageLoaded	content-network-image-loaded
contentsWillBeUpdated	contents-will-be-updated
contributeDependencies	contribute-dependencies
convertByteArrayToUnsignedLong	convert-byte-array-to-unsigned-long
convertChoiceGroupCore	convert-choice-group-core
convertClass	convert-class
convertMethod	convert-method
convertSearchFilterToModelFilter	convert-search-filter-to-model-filter
convertSuffixes	convert-suffixes
convertTicker	convert-ticker
convertToNodes	convert-to-nodes
convertToRemoteIfNeeded	convert-to-remote-if-needed
convertToSingleLine	convert-to-single-line
convertToStaxLocation	convert-to-stax-location
convertToSwingIcon	convert-to-swing-icon
convertToUserEditableFormat	convert-to-user-editable-format
convertToken	convert-token
coordsAsString	coords-as-string
copyConstructor	copy-constructor
copyDeep	copy-deep
copyFileToProjectDir	copy-file-to-project-dir
copyRelativeProperties	copy-relative-properties
copyResourcesFromFile	copy-resources-from-file
copyRestOfAttribute	copy-rest-of-attribute
copyResult	copy-result
copyStreamsCloseAll	copy-streams-close-all
copyTables	copy-tables
correctDebugClassPath	correct-debug-class-path
countParts	count-parts
countPlanElements	count-plan-elements
countQuotes	count-quotes
cp	cp
cr	cr
createActions	create-actions
createAdapter	create-adapter
createAdaptor	create-adaptor
createAdvancedPanel	create-advanced-panel
createAdvice	create-advice
createAlphaMask	create-alpha-mask
createArrayList	create-array-list
createArrowAnchorShape	create-arrow-anchor-shape
createArtifacts	create-artifacts
createAttributeType	create-attribute-type
createBasicType	create-basic-type
createBeansXml	create-beans-xml
createBindableStatement	create-bindable-statement
createBshObject	create-bsh-object
createBubbling	create-bubbling
createBuildOrderList	create-build-order-list
createBundleNoLock	create-bundle-no-lock
createByteInstance	create-byte-instance
createCatalogBuffer	create-catalog-buffer
createChangeForConfig	create-change-for-config
createChild	create-child
createClassInstance	create-class-instance
createClassNameInput	create-class-name-input
createComboBoxUpdater	create-combo-box-updater
createCommandDropTable	create-command-drop-table
createCommandRemoveColumn	create-command-remove-column
createCompatibilityProblem	create-compatibility-problem
createCompleteDM	create-complete-dm
createCompletion	create-completion
createConfigFileManager	create-config-file-manager
createConfigOperation	create-config-operation
createContainerListener	create-container-listener
createContextSelector	create-context-selector
createContinuation	create-continuation
createDataObject	create-data-object
createDefaultBreakpointsColumn	create-default-breakpoints-column
createDefaultCache	create-default-cache
createDefaultEditorKit	create-default-editor-kit
createDefaultMoveProvider	create-default-move-provider
createDeprecatedShowInPackageExplorerAction	create-deprecated-show-in-package-explorer-action
createDetail1_1Name	create-detail-1-1-name
createEdgeAbove	create-edge-above
createEdgeWidthFormatAction	create-edge-width-format-action
createEditableButton	create-editable-button
createEditorFromCache	create-editor-from-cache
createElResolver	create-el-resolver
createEntityTable	create-entity-table
createEquals	create-equals
createEventProperty	create-event-property
createFieldAccessBlock	create-field-access-block
createFileOrFolder	create-file-or-folder
createFilterTable	create-filter-table
createFormPaneTableWrapLayout	create-form-pane-table-wrap-layout
createFromCP	create-from-cp
createFromInstanceResolverAnnotation	create-from-instance-resolver-annotation
createFromJS	create-from-js
createGapPanel	create-gap-panel
createGeneralizeTypeDescriptor	create-generalize-type-descriptor
createGradientTransform	create-gradient-transform
createGraphEdge	create-graph-edge
createHeaderElement	create-header-element
createHeadingLabel	create-heading-label
createHtmlEvent	create-html-event
createImageAcceptPresenter	create-image-accept-presenter
createInputMethod	create-input-method
createInputUser	create-input-user
createInternalContentHandler	create-internal-content-handler
createJAXBDispatch	create-jaxb-dispatch
createJavaProjectSearchScope	create-java-project-search-scope
createJaxbContextFromContextPath	create-jaxb-context-from-context-path
createJmsTemplate	create-jms-template
createJvmThreadInstanceTableMetaNode	create-jvm-thread-instance-table-meta-node
createKeyListener	create-key-listener
createLaunchConfigurationEditArea	create-launch-configuration-edit-area
createLibEnumResultItem	create-lib-enum-result-item
createLifecycle	create-lifecycle
createListEntries	create-list-entries
createLiteralFragment	create-literal-fragment
createLivenessItemsModel	create-liveness-items-model
createLocaleSpecificPropertiesFile	create-locale-specific-properties-file
createMacroUID	create-macro-uid
createManifestGroup	create-manifest-group
createMarshalMethod	create-marshal-method
createMembersToDeleteMap	create-members-to-delete-map
createMetaSchemaModel	create-meta-schema-model
createMethodComment	create-method-comment
createMethodTypeArguments	create-method-type-arguments
createMethodWrapper	create-method-wrapper
createModelSelectionPolicyAdapter	create-model-selection-policy-adapter
createMouseCenteredZoomAction	create-mouse-centered-zoom-action
createMouseInputListener	create-mouse-input-listener
createNLSEdits	create-nls-edits
createNameIdMap	create-name-id-map
createNamesArea	create-names-area
createNewHashCommon	create-new-hash-common
createNewRange	create-new-range
createNewSingleVariableDeclaration	create-new-single-variable-declaration
createNewTabActions	create-new-tab-actions
createNewTagElement	create-new-tag-element
createNodeBackgroundColorFormatAction	create-node-background-color-form-ataction
createObjectFactory	create-object-factory
createObservedObject	create-observed-object
createOpaqueBorder	create-opaque-border
createPageChildren	create-page-children
createPageCountVariable	create-page-count-variable
createPageNumberVariable	create-page-number-variable
createPluginParameterRequiredMessage	create-plugin-parameter-required-message
createPluginTabs	create-plugin-tabs
createPositionModel	create-position-model
createPresentation	create-presentation
createPrimaryEntry	create-primary-entry
createProjectCustomizerPanel	create-project-customizer-panel
createProjectProperties	create-project-properties
createPromptWhenStillOpenPref	create-prompt-when-still-open-pref
createPropPanel	create-prop-panel
createPropertyElement	create-property-element
createRedirect	create-redirect
createRegularExpression	create-regulare-xpression
createReplaceLabelAndField	create-replace-label-and-field
createResizeHandler	create-resize-handler
createResolver	create-resolver
createResourceEnvRefKey	create-resource-env-ref-key
createResourceInfoResolver	create-resource-info-resolver
createRightBorder	create-right-border
createRootPageLink	create-root-page-link
createSAAJInfo	create-saaj-info
createSCConfiguration	create-sc-configuration
createScopedProxy	create-scoped-proxy
createSecurityPolicyQName	create-security-policy-q-name
createSequential	create-sequential
createServerDataSource	create-server-data-source
createServerORB	create-server-orb
createServerResponse	create-server-response
createSimpleCSRepeatedSubItem	create-simple-cs-repeated-sub-item
createSlidingModeAccessors	create-sliding-mode-accessors
createSourceContributor	create-source-contributor
createSourcePanel	create-source-panel
createSourceViewerComposite	create-source-viewer-composite
createSourcesToTestsMap	create-sources-to-tests-map
createSpellingProblemCollector	create-spelling-problem-collector
createSrcResources	create-src-resources
createStartingSpace	create-starting-space
createStringWriter	create-string-writer
createStroke	create-stroke
createSubPanel	create-sub-panel
createSuccessorsPanel	create-successors-panel
createSuperClassControls	create-super-class-controls
createSuperWildCardType	create-super-wild-card-type
createTabState	create-tab-state
createTagFileInfo	create-tag-file-info
createTargetArea	create-target-area
createTextCell	create-text-cell
createThread	create-thread
createThresholdedIdlingManager	create-thresholded-idling-manager
createTimeline	create-time-line
createTopBorder	create-top-border
createTransferable	create-transferable
createTreePath	create-tree-path
createTubelines	create-tube-lines
createURILibrary	create-uri-library
createURLStreamHandler	create-url-stream-handler
createVersionRanges	create-version-ranges
createWagon	create-wagon
createWaitScreenCommandParameter	create-wait-screen-command-parameter
createWheelPanAction	create-wheel-pan-action
createWindowRelativeRange	create-window-relative-range
createWithCustomLookup	create-with-custom-lookup
credsToTicket	creds-to-ticket
critiqueASAP	critique-asap
currentThreadIsTransactionThread	current-thread-is-transaction-thread
currentWrapper	current-wrapper
customize	customize
cv	cv
cwDateTimeFormatPatterns	cw-date-time-format-patterns
d	d
dataToJDouble	data-to-j-double
data_type	data-type
dd	dd
deJar	de-jar
declError	decl-error
declarationOfType	declaration-of-type
declareParameter	declare-parameter
declarePrefixes	declare-prefixes
decodeEIIIndexLarge	decode-eii-index-large
decodeFormat1Instruction	decode-format-1-instruction
decodeNumericChar	decode-numeric-char
decodeQueryStringImpl	decode-query-string-impl
decompressPoint	decompress-point
decryptElementContent	decrypt-element-content
defElement	def-element
defaultButtonText	default-button-text
defaultDebugStartDesc	default-debug-start-desc
defaultTypeFieldFocusGained	default-type-field-focus-gained
defineAll	defin-eall
defineExt	define-ext
defineGrammarSymbols	define-grammar-symbols
defineInterceptors	define-interceptors
delFieldAssignImpl	del-field-assign-impl
deleteCacheFile	delete-cache-file
deleteDataValue	delete-data-value
deprecatedTagOutput	deprecated-tag-output
deque_clear	deque-clear
deregisterActor	deregister-actor
derivedFrom	derived-from
des_set_key	des-set-key
describeEndpoint	describe-endpoint
deserialiseItem	deserialise-item
destinationEmptyMessage	destination-empty-message
destroyPrototypeInstance	destroy-prototype-instance
deteleDefaultStorage	detele-default-storage
determineDialect	determine-dialect
determineSql	determine-sql
devoidify	devoidify
df	df
dictproxy___le__	dictproxy-le
dictproxy_keys	dictproxy-keys
diiForImplicitOperation	dii-for-implicit-operation
directSubclasses	direct-subclasses
directoryList	directory-list
directoryRadioSelected	directory-radio-selected
disableCache	disable-cache
disableEvents	disable-events
disableProject2	disable-project-2
disableProject3	disable-project-3
disableResizedPosting	disable-resized-posting
discardAllEdits	discard-all-edits
disconnectFromHost	disconnect-from-host
disjoint	disjoint
dispatchStart	dispatch-start
displayRepositoryForm	display-repository-form
displayToolbarItem	display-toolbar-item
displayedGroupsListValueChanged	displayed-groups-list-value-changed
disposeActions	dispose-actions
disposeParentWindow	dispose-parent-window
distributeSpace	distribute-space
dl	dl
doDialog	do-dialog
doFinally	do-finally
doFormatPreview	do-format-preview
doGetColumnInfo	do-get-column-info
doGetItems	do-get-items
doGetSource	do-get-source
doHandleExtension	do-handle-extension
doInvokeAndForget	do-invoke-and-forget
doListenerNotifications	do-listener-notifications
doOperation	do-operation
doOptimisticDisconnect	do-optimistic-disconnect
doPageEnd	do-page-end
doPlatformRunnable	do-platform-runnable
doPrepareRequestBuilder	do-prepare-request-builder
doPrjUnPack	do-prj-un-pack
doRemoveArtifact	do-remove-artifact
doReportUserHomeLibraries	do-report-user-home-libraries
doScriptableIncrDecr	do-scriptable-incr-decr
doSelectionChanged	do-selection-changed
doSetAsText	do-set-as-text
doShrink	do-shrink
doSingleTransfer	do-single-transfer
doStreamingSearch	do-streaming-search
doTeamSettings	do-team-settings
dockIntoImpl	dock-into-impl
doesSubKeyExist	does-sub-key-exist
doneDecoding	done-decoding
done_parsing	done-parsing
downloadDependencyAndJavadocSource	download-dependency-and-javadoc-source
dragDetect	drag-detect
dragStarted	drag-started
drawCornerTextItems	draw-corner-text-items
drawDateLine	draw-date-line
drawPolygon	draw-polygon
drawRimCoords	draw-rim-coords
drawTextAntialiased	draw-text-antialiased
drawWrappedString	draw-wrapped-string
driveToClass	drive-to-class
dropDownMenuPopupMenuWillBecomeVisible	drop-down-menu-popup-menu-will-become-visible
dropSchema	drop-schema
dt	dt
dumpClassLoaders	dump-class-loaders
dumpElementStructure	dump-element-structure
dumpHexBuffer	dump-hex-buffer
dumpRelationList	dump-relation-list
dumpSignatures	dump-signatures
dumpThreadGroup	dump-thread-group
dump_entry_variable	dump-entry-variable
e	e
e0	e-0
e1	e-1
e2	e-2
e3	e-3
e4	e-4
e5	e-5
e6	e-6
e7	e-7
e8	e-8
e9	e-9
egualMethodSignatures	egual-method-signatures
ejbActivate	ejb-activate
elementAtOffset	element-at-offset
elementDecode	element-decode
eliminateNots	eliminate-nots
em	em
emitDataflowWarning	emit-dataflow-warning
emptyCollector	empty-collector
emptyControlFlowStatement	empty-control-flow-statement
en	en
enableDisableAttachToolbarButton	enable-disable-attach-toolbar-button
enableJnlp	enable-jnlp
enableLegacyHibernateValidator	enable-legacy-hibernate-validator
enclosingRootInfo	enclosing-root-info
encodeBufferSuffix	encode-buffer-suffix
encodeStubInAddress	encode-stub-in-address
encodeToBytes	encode-to-bytes
endTestSuite	end-test-suite
endTryBlock	end-try-block
engineGenerateCertificate	engine-generate-certificate
engineGetKey	engine-get-key
engineSetPadding	engine-set-padding
ensureAWTShape	ensure-awt-shape
ensureBLayerDataInBuffer	ensure-b-layer-data-in-buffer
ensureDateTimeFormatInfo	ensure-date-time-format-info
ensureExistingFileInfoContainer	ensure-existing-file-info-container
ensureProtectedAccess	ensure-protected-access
ensureSavingFirst	ensure-saving-first
ensureTarSourceIsValid	ensure-tar-source-is-valid
enterIgnoreTargetFolder	enter-ignore-target-folder
enterReferenceKind	enter-reference-kind
entryFromArchive	entry-from-archive
enumAbstractMethodMustBeImplemented	enum-abstract-method-must-be-implemented
eq	eq
equalsFORKKind	equals-fork-kind
equalsHelper	equals-helper
equivalence_set_list	equivalence-set-list
errorNoMethodFor	error-no-method-for
es	es
escapeTabs	escape-tabs
establishTransactionalWriter	establish-transactional-writer
estimateVariables	estimate-variables
evaluateOld	evaluate-old
evaluatePDF417	evaluate-pdf417
ex	ex
excludeCheckActionPerformed	exclude-check-action-performed
excludeExtensionPrefixes	exclude-extension-prefixes
executeFunction	execute-function
executeOnSucess	execute-on-sucess
executeTarget	execute-target
exitEditRequest	exit-edit-request
expandAndAdd	expand-and-add
expandElement	expand-element
expandName	expand-name
expandNegatedRequirement	expand-negated-requirement
expandTabToSpaces	expand-tab-to-spaces
expiryDate2DeltaSeconds	expiry-date-2-delta-seconds
exportReportToWriter	export-report-to-writer
exposeErrorRequestAttributes	expose-error-request-attributes
extInstanceof	ext-instanceof
extendPathPrefix	extend-path-prefix
extractConstraintName	extract-constraint-name
extractDeclarations	extract-declarations
extractFullFilenameFromUrlPath	extract-full-filename-from-url-path
extractHandlerMethodUriTemplates	extract-handler-method-uri-templates
extractOption	extract-option
extractRuby	extract-ruby
extractSQLState	extract-sql-state
extractSqlStateClassCode	extract-sql-state-class-code
extractStrings	extract-strings
extractUserNameFromScopedName	extract-user-name-from-scoped-name
f	f
f1	f-1
f2	f-2
f3	f-3
f4	f-4
f5	f-5
f_inspect	f-inspect
failureDetected	failure-detected
fastGetAttributes	fast-get-attributes
fe	fe
featureInstalled	feature-installed
fetchLocalizedAttributeValues	fetch-localized-attribute-values
fetchNotifications	fetch-notifications
ff	ff
fieldInfo	field-info
fieldInsn	field-insn
fieldIsObject	field-is-object
fileCreatedEventHandler	file-created-event-handler
fileEntry	file-entry
fileOutput	file-output
fileSystemPoolReordered	file-system-pool-reordered
fillArrays	fill-arrays
fillLocationViewerContextMenu	fill-location-viewer-context-menu
fillPageBreak	fill-page-break
fillRowGaps	fill-row-gaps
filterChildren	filter-children
filterFeatures	filter-features
filtersSet	filters-set
finalSubString	final-sub-string
findAllBelowBranch	find-all-below-branch
findApiPackageDiffGenerator	find-api-package-diff-generator
findAutowiredAnnotation	find-autowired-annotation
findBases	find-bases
findBindingAnnotation	find-binding-annotation
findByItemId	find-by-item-id
findClassVar	find-class-var
findCode	find-code
findColumnInsenstive	find-column-insenstive
findComp	find-comp
findCond	find-cond
findConf	find-conf
findContentTypesFor	find-content-types-for
findCreator	find-creator
findDBConn	find-db-conn
findDescriptionComponent	find-description-component
findDocAPIDirs	find-doc-api-dirs
findEnvironment	find-environment
findFieldsAndMethodsFromMissingType	find-fields-and-methods-from-missing-type
findHyperlinkToken	find-hyperlink-token
findIgnoreCase	find-ignore-case
findImportPackages	find-import-packages
findIndexPeak	find-index-peak
findJavaElement	find-java-element
findJavaPlatformByLocation	find-java-platform-by-location
findLabelFor	find-label-for
findLastTokenBounds	find-last-token-bounds
findLastTypeArgumentInfo	find-last-type-argument-info
findMainClass	find-main-class
findMatchingDecoratorDefs	find-matching-decorator-defs
findMethodIndex	find-method-index
findNativePath	find-native-path
findOpenInstance	find-open-instance
findOpenTextEditorFor	find-open-text-editor-for
findParentTopComponent	find-parent-top-component
findPlannerMarkedIUs	find-planner-marked-ius
findPluginById	find-plugin-by-id
findPrev	find-prev
findPropertiesByPrefix	find-properties-by-prefix
findProperty	find-property
findPropertyInClassHierarchy	find-property-in-class-hierarchy
findSecurityConstraints	find-security-constraints
findSubDeltaParent	find-sub-delta-parent
findTagValues	find-tag-values
findTestsInContainer	find-tests-in-container
findTocExtensionResult	find-toc-extension-result
findTypeNames	find-type-names
findUnshardableLinkers	find-unshardable-linkers
findWadlFile	find-wadl-file
findWebServicesSupport	find-web-services-support
finishDblQuote	finish-dbl-quote
finishSettings	finish-settings
finishTypeMungers	finish-type-mungers
fireAppointmentRemoved	fire-appointment-removed
fireBreakpointCreated	fire-break-point-created
fireBundleDataChanged	fire-bundle-data-changed
fireCaretUpdate	fire-caret-update
fireCellClicked	fire-cell-clicked
fireFocus	fire-focus
fireGemsChanged	fire-gems-changed
fireLA	fire-la
fireNewLine	fire-new-line
fireObjectRenamed	fire-object-renamed
firePostSelectionEvent	fire-post-selection-event
fireServiceRemoved	fire-service-removed
fireShortDescriptionChange	fire-short-description-change
fireShowLiveness	fire-show-liveness
fireSnapshotLoaded	fire-snapshot-loaded
fireTableUpdate	fire-table-update
fireTestFailure	fire-test-failure
fireTestRunFinished	fire-test-run-finished
firstOverlap	first-overlap
fixExecution	fix-execution
fixMnemonic	fix-mnemonic
fixnumNode	fixnum-node
floatValue	float-value
float___abs__	float-abs
float___rmod__	float-rmod
flowEUSRIDPWDconnect	flow-eusridpwd-connect
flushBeforeSeek	flush-before-seek
flushComposable	flush-composable
flushIfNecessary	flush-if-necessary
flushPluginsRootCharacters	flush-plugins-root-characters
fm	fm
focusForm	focus-form
foldSetParent	fold-set-parent
fontExists	font-exists
footer	footer
forFileObject	for-file-object
forSignatures	for-signatures
forTask	for-task
forceConversion	force-conversion
forceMultiple	force-multiple
forcedLatinDigits	forced-latin-digits
formMove2	form-move2
formMoved	form-moved
formatMonthNumDay	format-month-num-day
formatPaddLeft	format-padd-left
formattersRemoveButtonActionPerformed	formatters-remove-button-action-performed
foundInGlueAnchor	found-in-glue-anchor
foundModules	found-modules
framing	framing
freeArrayRef	free-array-ref
freeLongPointer	free-long-pointer
freeNativeData	free-native-data
fromPropertiesString	from-properties-string
fromVisitedInstruction	from-visited-instruction
fromVisitedMethod	from-visited-method
fullyUnlock	fully-unlock
functionProximateOrContainsProximate	function-proximate-or-contains-proximate
g	g
g_app_info_create_from_commandline	g-app-info-create-from-commandline
g_malloc	g-malloc
gc	gc
ge	ge
genDefaultsAccessable	gen-defaults-accessable
genStartStoreCode	gen-starts-to-recode
genSynPred	gen-syn-pred
genWriteType	gen-write-type
generateAscEndName	generate-asc-end-name
generateBundles	generate-bundles
generateCodeAttributeForProblemMethod	generate-code-attribute-for-problem-method
generateDeleteRowString	generate-delete-row-string
generateDom4jElement	generate-dom4j-element
generateEnumTypes	generate-enum-types
generateEpisodeFile	generate-episode-file
generateFeatureIUs	generate-feature-ius
generateG	generate-g
generateH	generate-h
generateInsertRowString	generate-insert-row-string
generateK	generate-k
generateNativeFunctionOverrides	generate-native-function-overrides
generateNoArgConstructorCall	generate-no-arg-constructor-call
generateNonConstantName	generate-non-constant-name
generateOldData	generate-old-data
generateOperationNameAndTestForConstructor	generate-operation-name-and-test-for-constructor
generateOverviews	generate-overviews
generatePerTypeWithinCreateAspectInstanceMethod	generate-per-type-within-create-aspect-instanc-emethod
generateProxyClass	generate-proxy-class
generatePushWrappedArgs	generate-push-wrapped-args
generateR	generate-r
generateRegexp	generate-regexp
generateRequireBundle	generate-require-bundle
generateReturnCode	generate-return-code
generateS	generate-s
generateScriptStart	generate-script-start
generateString	generate-string
generateTimestampToken	generate-timestamp-token
generateUniqueLaunchConfigurationNameFrom	generate-unique-launch-configuration-name-from
generateV	generate-v
generateW	generate-w
generateWindow	generate-window
generateWsgenReport	generate-wsgen-report
generateX	generate-x
generateY	generate-y
generated	generated
generator	generator
generic_exception_types	generic-exception-types
getAMXProxyFactory	get-amx-proxy-factory
getAbsoluteClusterPath	get-absolute-cluster-path
getAbsoluteEntries	get-absolute-entries
getAbsoluteX	get-absolute-x
getAbsoluteY	get-absolute-y
getAbstractFileSystem	get-abstract-file-system
getAccessCount	get-access-count
getAccessFactory	get-access-factory
getAccessStack	get-access-stack
getAccessUpdateMember	get-access-update-member
getAccessibleIndexInParent	get-accessible-index-in-parent
getAccessiblePropertyFields	get-accessible-property-fields
getAccessibleRelationSet	get-accessible-relation-set
getAcknowledgeMode	get-acknowledge-mode
getActionByVerb	get-action-by-verb
getActivateTimeout	get-activate-timeout
getActualVCType	get-actual-vc-type
getAdapteeFunction	get-adaptee-function
getAddInstanceIterator	get-add-instance-iterator
getAdditionalConfigurationComponent	get-additional-configuration-component
getAdminObjects	get-admin-objects
getAlgorithmURI	get-algorithm-uri
getAllAncestors	get-all-ancestors
getAllAnnotations	get-all-annotations
getAllBundles	get-all-bundles
getAllBytes	get-all-bytes
getAllCVSProjects	get-all-cvs-projects
getAllPermissionCollection	get-all-permission-collection
getAllPossibleNamespaces	get-all-possible-name-spaces
getAllResouces	get-all-resouces
getAllSubSystems	get-all-subsystems
getAllocPage	get-alloc-page
getAllocation	get-allocation
getAlphaDouble	get-alpha-double
getAlreadyExecuted	get-already-executed
getAlternateURL	get-alternate-url
getAnnotationDeclarations	get-annotation-declarations
getAntDebugController	get-ant-debug-controller
getApiFieldsBySet	get-api-fields-by-set
getAppClients	get-app-clients
getApplicationInstaller	get-application-installer
getArgClass	get-arg-class
getArgIndex	get-arg-index
getArgType	get-arg-type
getArgumentTypeName	get-argument-type-name
getArgumentTypeWackyHack	get-argument-type-wacky-hack
getArrayReference	get-array-reference
getArtifactIds	get-artifact-ids
getArtifactKey	get-artifact-key
getAsComboModel	get-as-combo-model
getAsIsPayload	get-as-is-payload
getAsLocation	get-as-location
getAspectJAdviceMethod	get-aspect-j-advice-method
getAssemblyDesc	get-assembly-desc
getAssistantContext	get-assistant-context
getAssnOwnerGuid	get-assn-owner-guid
getAstCompilationUnit	get-ast-compilation-unit
getAtIndex	get-at-index
getAtLeast	get-at-least
getAttrValueNS	get-attr-value-ns
getAttributeConditionNames	get-attribute-condition-names
getAttributeRegion	get-attribute-region
getAuthLoginDisable	get-auth-login-disable
getAutoEditStrategies	get-auto-edit-strategies
getAutoRangeStickyZero	get-auto-range-sticky-zero
getAvailableLoad	get-available-load
getAvailableRelationTypeSelection	get-available-relation-type-selection
getAvailableRenderer	get-available-renderer
getAvailableUpdates	get-available-updates
getAzStyleClientName	get-az-style-client-name
getBackgroundNoInit	get-background-no-init
getBarFormat	get-bar-format
getBarTextDateFormat	get-bar-text-date-format
getBaseLineInfo	get-base-line-info
getBasicBundleLoader	get-basic-bundle-loader
getBasicUsageHelp	get-basic-usage-help
getBdescriptor	get-bdescriptor
getBeforeMethods	get-before-methods
getBlockEvents	get-block-events
getBlockedCount	get-blocked-count
getBodyDeclarationNode	get-body-declaration-node
getBooleanAttribute	get-boolean-attribute
getBootClassPathEntryForResource	get-boot-class-path-entry-for-resource
getBoxContainer	get-box-container
getBreakHeight	get-break-height
getBreakpointListeners	get-breakpoint-listeners
getBrokenDependency2Plugins	get-broken-dependency-2-plugins
getBrowserActionSet	get-browser-action-set
getBrowserHeadersToUse	get-browser-headers-to-use
getBrowserProxyHandler	get-browser-proxy-handler
getBugFilingLink	get-bug-filing-link
getBugtrackingConnectors	get-bug-tracking-connectors
getBundleClass	get-bundle-class
getBundleGroups	get-bundle-groups
getBundleLoader	get-bundle-loader
getBundleManifestVersion	get-bundle-manifest-version
getBusinessRemoteHome	get-business-remote-home
getByteBlock	get-byte-block
getByteFromInt	get-byte-from-int
getCMNTCPIP	get-cmntcpip
getCacheMissCount	get-cache-miss-count
getCachedMethodsForWrite	get-cached-methods-for-write
getCachedPackage	get-cached-package
getCardType	get-card-type
getCaretLocation	get-caret-location
getCaretWidthPreference	get-caret-width-preference
getCategoryMiddle	get-category-middle
getCertificateRequestStore	get-certificate-request-store
getChangeLength	get-change-length
getCharContents	get-char-contents
getCharacterBounds	get-character-bounds
getCharsetFor	get-charset-for
getCheckBoxMenuItemCheckIcon	get-check-box-menu-item-check-icon
getCheckBoxMenuItemDefault	get-check-box-menu-item-default
getClassByName	get-class-by-name
getClassEntry	get-class-entry
getClassFileMajorVersion	get-class-file-major-version
getClassLiteralForPrimitive	get-class-literal-for-primitive
getClassLiteralLookup	get-class-literal-lookup
getClassNamespace	get-class-namespace
getClassReuseCount	get-class-reuse-count
getClassSearchName	get-class-search-name
getClassVersion	get-class-version
getClasspathContentProvider	get-classpath-content-provider
getClasspathVariable	get-classpath-variable
getClone	get-clone
getClose	get-close
getCloseConnectionSynchronization	get-close-connection-synchronization
getCloseJavacriptInternal	get-close-javacript-internal
getCloud	get-cloud
getCodeBase	get-code-base
getCoercion	get-coercion
getCollectMemoryUsage	get-collect-memory-usage
getColorHexa	get-color-hexa
getColumnHeaders	get-column-headers
getColumnTotalGroup	get-column-total-group
getCommonActionCodeForSelectedInfos	get-common-action-code-for-selected-infos
getCompatibleTypes	get-compatible-types
getCompiledClass	get-compiled-class
getCompletePathInArchive	get-complete-path-in-archive
getCompleteWorkKey	get-complete-work-key
getCompletionTextSel	get-completion-text-sel
getComponentDescriptorLocation	get-component-descriptor-location
getComponentSize	get-component-size
getComponentSpec	get-component-spec
getConcatenatedContents	get-concatenated-contents
getConfiguration	get-configuration
getConfigurationByDisplayName	get-configuration-by-display-name
getConfigurationPolicyModel	get-configuration-policy-model
getConfirmEvents	get-confirm-events
getConnectedConnectionCount	get-connected-connection-count
getConnectionFactories	get-connection-factories
getConnectionInstance	get-connection-instance
getConnectionPool	get-connection-pool
getConnectorGBeanInfo	get-connector-g-bean-info
getConnectorModuleBuilder	get-connector-module-builder
getConstNode	get-const-node
getConstTagDefinition4Parameter	get-const-tag-definition-4-parameter
getConstantNoConstMissing	get-constant-no-const-missing
getConstraintOrderedTableNameClosure	get-constraint-ordered-table-name-closure
getConstraintValue	get-constraint-value
getContainerSpace	get-container-space
getContainerVersion	get-container-version
getContentAssistCommandAdapter	get-content-assist-command-adapter
getContentNetwork	get-content-network
getContentPublisher	get-content-publisher
getContentsOfFile	get-contents-of-file
getContextMech	get-context-mech
getContextMenu	get-context-menu
getCoolBarManager2	get-cool-bar-manager2
getCoreListType	get-core-list-type
getCorePoolSize	get-core-pool-size
getCorrelationParent	get-correlation-parent
getCounter	get-counter
getCountry	get-country
getCreateHandle	get-create-handle
getCurrentEventImpl	get-current-event-impl
getCurrentFile	get-current-file
getCurrentFocusOwner	get-current-focus-owner
getCurrentLanguage	get-current-language
getCurrentMessages	get-current-messages
getCurrentReadOnlyFlag	get-current-read-only-flag
getCurrentSchemaName	get-current-schema-name
getCurrentTargetKey	get-current-target-key
getCustomMediaSizeNames	get-custom-media-size-names
getCustomSQLUpdate	get-custom-sql-update
getCustomScreenSizes	get-custom-screen-sizes
getCustomTypeConverter	get-custom-type-converter
getCyclicProjects	get-cyclic-projects
getDBElement	get-db-element
getDCHuffmanTable	get-dc-huffman-table
getDLightConfigurationUIWrappers	get-d-light-configuration-ui-wrappers
getDOMsystemID	get-dom-system-id
getDanglingReferences	get-dangling-references
getDart	get-dart
getDataUris	get-data-uris
getDataViewer	get-data-viewer
getDatabaseSnapshot	get-database-snapshot
getDayOfMonth	get-day-of-month
getDebuggerObject	get-debugger-object
getDeclarationFromStatic	get-declaration-from-static
getDeclaredFields	get-declared-fields
getDeclaringContainerName	get-declaring-container-name
getDefOwner	get-def-owner
getDefaultBounds	get-default-bounds
getDefaultCabFileLocation	get-default-cab-file-location
getDefaultEncodingScheme	get-default-encoding-scheme
getDefaultEnumMemberSizeCap	get-default-enum-member-size-cap
getDefaultFilterType	get-default-filter-type
getDefaultFontFile	get-default-font-file
getDefaultLogicalFont	get-default-logical-font
getDefaultPackageRootPath	get-default-package-root-path
getDefaultTextCharset	get-default-text-charset
getDefaultValueAsString	get-default-value-as-string
getDefaultValueProposals	get-default-value-proposals
getDefines	get-defines
getDelayInitialRead	get-delay-initial-read
getDelegate	get-delegate
getDeleteNodeOperation	get-delete-node-operation
getDependants	get-dependants
getDependencyContainer	get-dependency-container
getDescriptionXmlLang	get-description-xml-lang
getDescritption	get-descritption
getDirectInheritedClasses	get-direct-inherited-classes
getDispatchMethod	get-dispatch-method
getDocRootAttributes	get-doc-root-attributes
getDockingRatio	get-docking-ratio
getDocumentContent	get-document-content
getDocumentContext	get-document-context
getDomainAxis	get-domain-axis
getDomainLibDirectory	get-domain-lib-directory
getDomainRoot	get-domain-root
getDomainScriptDirPath	get-domain-script-dir-path
getDoubleAverage	get-double-average
getDropinsDirectories	get-dropins-directories
getDroppedDataObject	get-dropped-data-object
getEditedScreen	get-edited-screen
getEditorActionsMap	get-editor-actions-map
getEjbLocalRefs	get-ejb-local-refs
getEjbReference	get-ejb-reference
getElementClass	get-element-class
getEmptyValueRow	get-empty-value-row
getEmptyView	get-empty-view
getEnablementToMigrate	get-enablement-to-migrate
getEnclosingDeclaration	get-enclosing-declaration
getEncoderMappingTable	get-encoder-mapping-table
getEndElement	get-end-element
getEndPointAddressString	get-end-point-addresss-tring
getEntityLockMonitor	get-entity-lock-monitor
getEntityManagerFieldInfo	get-entity-manager-field-info
getEnvironmentEntries	get-environment-entries
getErrorDialogMessage	get-error-dialog-message
getErrorObject	get-error-object
getErrorPage	get-error-page
getErrorPane	get-error-pane
getErrorPath	get-error-path
getEscapedName	get-escaped-name
getExecutionProject	get-execution-project
getExitScroll	get-exit-scroll
getExpirationMaxIdle	get-expiration-max-idle
getExplodedPieArea	get-exploded-pie-area
getExponentialSymbol	get-exponential-symbol
getExtensionMapping	get-extension-mapping
getExtensionName	get-extension-name
getExtensionStateService	get-extension-state-service
getExtraArgs	get-extra-args
getExtraDataPosition	get-extra-data-position
getExtraSourceLocations	get-extra-source-locations
getFKInfo	get-fk-info
getFactAfterLocation	get-fact-after-location
getFallbackClassLoader	get-fallback-class-loader
getFastViewManager	get-fast-view-manager
getFetchedWith	get-fetched-with
getFieldErrorFieldNames	get-field-error-field-names
getFieldMapping	get-field-mapping
getFieldable	get-fieldable
getFileChecksum	get-file-checksum
getFileDisplayName	get-file-display-name
getFileExtensionAssociation	get-file-extension-association
getFileObjForFileOrParent	get-file-obj-for-file-or-parent
getFileProperty	get-file-property
getFileScannerList	get-file-scanner-list
getFileStatusCache	get-file-status-cache
getFileStoreFileBuffer	get-file-store-file-buffer
getFileToolbar	get-file-toolbar
getFilesWithPerformanceWarning	get-files-with-performance-warning
getFilterByteOffset	get-filter-byte-offset
getFilterOutPatterns	get-filter-out-patterns
getFilteredMemberAccessibility	get-filtered-member-accessibility
getFinallyStatement	get-finally-statement
getFirstBaseDeclarations	get-first-base-declarations
getFirstChange	get-first-change
getFirstFailTime	get-first-fail-time
getFlatCategory	get-flat-category
getFlavorToNative	get-flavor-to-native
getFocusImplForPanel	get-focus-impl-for-panel
getFolded	get-folded
getFolder	get-folder
getFolderClosed	get-folder-closed
getFolderSyncInfo	get-folder-sync-info
getFontChanged	get-font-changed
getFormDesignClass	get-form-design-class
getFormInfoForKnownClass	get-form-info-for-known-class
getFreemarkerModels	get-free-marker-models
getFullGoalName	get-full-goal-name
getFullyRFC2396CompliantURL	get-fully-rfc2396-compliant-url
getFwName	get-fw-name
getGanttProjectSingleton	get-gantt-project-singleton
getGemRequirementsForTests	get-gem-requirements-for-tests
getGeneralizedType	get-generalized-type
getGeneratedManifest	get-generated-manifest
getGeneratedName	get-generated-name
getGenericParametersAsString	get-generic-parameters-as-string
getGlobalCRC	get-global-crc
getGlobalCfg	get-global-cfg
getGlyphCodes	get-glyph-codes
getGrammar	get-grammar
getGraphFrameCanvasFocus	get-graph-frame-canvas-focus
getGroupOpenedTopComponentsIDs	get-group-opened-top-components-ids
getGuardedList	get-guarded-list
getGwtVersionNum	get-gwt-version-num
getGzipFileHandler	get-gzip-file-handler
getHTMLLineNo	get-html-line-no
getHasTimephasedData	get-has-timephased-data
getHeaderOrParameterDefinition	get-header-or-parameter-definition
getHeapDumpProject	get-heap-dump-project
getHierarchyManager	get-hierarchy-manager
getHigh	get-high
getHighPrecisionCounter	get-high-precision-counter
getHint	get-hint
getHits	get-hits
getHold	get-hold
getHome	get-home
getHomeMapping	get-home-mapping
getHook	get-hook
getHookName	get-hook-name
getHorizontalSubsampling	get-horizontal-subsampling
getHost	get-host
getHour	get-hour
getHoverLineRange	get-hover-line-range
getI18Nkey	get-i18n-key
getIMember	get-i-member
getIOManager	get-io-manager
getIPv6	get-ipv6
getIconPalette	get-icon-palette
getIdFieldUriParamArray	get-id-field-uri-param-array
getIdSetter	get-id-setter
getIdealImageName	get-ideal-image-name
getIiopopts	get-iiopopts
getImpliedJoin	get-implied-join
getImportedByFragments	get-imported-by-fragments
getImportingNamespace	get-importing-namespace
getInactiveCode	get-inactive-code
getIncludeLocation	get-include-location
getIncludeMethodsSet	get-include-methods-set
getIncludedFeature	get-included-feature
getIncludedPath	get-included-path
getInclusionGraph	get-inclusion-graph
getIndentLevel	get-indent-level
getIndentationPanel	get-indentation-panel
getIndexArray	get-index-array
getIndexColumnPositions	get-index-column-positions
getIndexInfoForODBC	get-index-info-for-odbc
getIndexInfoQuery	get-index-info-query
getIndexedArgs	get-indexed-args
getInheritedMethods	get-inherited-methods
getInitial	get-initial
getInitialArgs	get-initial-args
getInitialCapacity	get-initial-capacity
getInitialPolicies	get-initial-policies
getInitialRepetitions	get-initial-repetitions
getInitialize	get-initialize
getInitializeChangeTicks	get-initialize-change-ticks
getInitiationAction	get-initiation-action
getInputResultName	get-input-result-name
getInputURI	get-input-uri
getInputUrl	get-input-url
getInsertConstantAction	get-insert-constant-action
getInsertValues	get-insert-values
getInsertedEdges	get-inserted-edges
getInsertedProjectsLikeSummary	get-inserted-projects-like-summary
getIntDatum	get-int-datum
getIntOrCP	get-int-or-cp
getInterestingProjects	get-interesting-projects
getInterlaceMethod	get-interlace-method
getInternal2ExternalRow	get-internal-2-external-row
getInternalAddresses	get-internal-addresses
getInternalCSSValue	get-internal-css-value
getInternalCounters	get-internal-counters
getInternalElts	get-internal-elts
getInternalKeymapProfile	get-internal-keymap-profile
getInternalPatterns	get-internal-patterns
getInvalidByteSequenceError	get-invalid-byte-sequence-error
getIsMainProject	get-is-main-project
getIssueTypes	get-issue-types
getIssuerDN	get-issuer-dn
getItemLabel	get-item-label
getItemParameterName	get-item-parameter-name
getJ2seConnectionUrl	get-j2se-connection-url
getJLCInfo	get-jlc-info
getJMSRedelivered	get-jms-redelivered
getJMSResources	get-jms-resources
getJSPColoringData	get-jsp-coloring-data
getJVMLocation	get-jvm-location
getJarPathArray	get-jar-path-array
getJavaClassFromNode	get-java-class-from-node
getJavaInvocationBody	get-java-invocation-body
getJavaObjectsExposedInBrowser	get-java-objects-exposed-in-browser
getJavaParameter	get-java-parameter
getJavacSourceLevel	get-javac-source-level
getJavadocBaseLocation	get-javadoc-base-location
getJobFamily	get-job-family
getJustificationInfos	get-justification-infos
getJvmOSName	get-jvm-os-name
getKeeproot	get-keep-root
getKeyPasswd	get-key-passwd
getKeyStrokesForAction	get-key-strokes-for-action
getKnownRepositoryUrls	get-known-repository-urls
getLabelAdapter	get-label-adapter
getLabelContent	get-label-content
getLabelContext	get-label-context
getLastFinalLocation	get-last-final-location
getLastOpenProjectDir	get-last-open-project-dir
getLastUnfilledPage	get-last-unfilled-page
getLastUpdateCheck	get-last-update-check
getLayoutFileName	get-layout-file-name
getLazyMethodGen	get-lazy-method-gen
getLazyValueDefaults	get-lazy-value-defaults
getLibElements	get-lib-elements
getLineBegin	get-line-begin
getLineVisible	get-line-visible
getLiteralsCompartment	get-literals-compartment
getLoadDistribution	get-load-distribution
getLoadedBy	get-loaded-by
getLoadedElementsIterator	get-loaded-elements-iterator
getLoaderForClass	get-loader-for-class
getLocalAddress	get-local-address
getLocalExplicitMethods	get-local-explicit-methods
getLocalPort	get-local-port
getLocalisedMessageText	get-localised-message-text
getLockedAction	get-locked-action
getLog2SegmentSize	get-log2-segment-size
getLogLevel	get-log-level
getLogLevelMenuItems	get-log-level-menu-items
getLogicalFontFaceName	get-logical-font-face-name
getLogicalView	get-logical-view
getLoginPageUrl	get-login-page-url
getLookupsList	get-lookups-list
getLowSrc	get-low-src
getMFunctionReturnType	get-m-function-return-type
getMSAInfo	get-msa-info
getMVTCDisplayName	get-mvtc-display-name
getMacDylibAddress	get-mac-dylib-address
getMacroExpansionDocProvider	get-macro-expansion-doc-provider
getMacroName	get-macro-name
getMagicInt32	get-magic-int32
getMainTag	get-main-tag
getMainURL	get-main-url
getMapMembersExcl	get-map-members-excl
getMapValueFieldType	get-map-value-field-type
getMappedResourceVisitor	get-mapped-resource-visitor
getMappingFileDataInTargetPkg	get-mapping-file-data-in-target-pkg
getMarginHeight	get-margin-height
getMarkerFactory	get-marker-factory
getMarkupType	get-markup-type
getMasterModuleSpecificationVersion	get-master-module-specification-version
getMatchBracket	get-match-bracket
getMatchingRuleName	get-matching-rulename
getMaxBufferSize	get-max-buffer-size
getMaxChipX	get-max-chip-x
getMaxChipY	get-max-chip-y
getMaxComparatorValue	get-max-comparator-value
getMaxInclusives	get-max-inclusives
getMaxIterations	getmaxiterations
getMaxPolyphony	getmaxpolyphony
getMaximizedBounds	getmaximizedbounds
getMechStr	getmechstr
getMenuItemIsVisible	getmenuitemisvisible
getMergeType	getmergetype
getMessageDestination	getmessagedestination
getMessageID	getmessage-id
getMessageId	getmessage-id
getMessageid	getmessage-id
getMetaArea	get-meta-area
getMetaDataInfoBoolean	get-meta-data-info-boolean
getMetaInfEntryNames	get-meta-inf-entry-names
getMetadataString	get-meta-data-string
getMethodClassName	get-method-class-name
getMethodForBinding	get-method-for-binding
getMinTasks	get-min-tasks
getMinorTickMarkPaint	get-minor-tick-mark-paint
getModeStructureSnapshot	get-mode-structure-snapshot
getModelFile	get-model-file
getModifiedColumns	get-modified-columns
getModifiedParentFile	get-modified-parent-file
getModifiedResource	get-modified-resource
getModifiedSource	get-modified-source
getMostActiveJavaEditorContext	get-most-active-java-editor-context
getMostRecentMethodName	get-most-recent-method-name
getMoveBackLength	get-move-back-length
getMoveMode	get-move-mode
getMppFileType	get-mpp-file-type
getMssSize	get-mss-size
getMultiDOMMask	get-multi-dom-mask
getMultipleFiles	getmultiple-files
getMultiplicityManyRadioButton	get-multiplicity-many-radio-button
getMyeBayBuying	get-my-ebay-buying
getNProfiledClasses	get-n-profiled-classes
getNTLMUserName	get-ntlm-user-name
getNameWithoutExtension	get-name-without-extension
getNamedFrame	get-named-frame
getNativeEntityManagerFactory	get-native-entity-manager-factory
getNativeLibName	get-native-lib-name
getNatureDescriptor	get-nature-descriptor
getNavigationRuleExtensions	get-navigation-rule-extensions
getNaviviewExpanded	get-naviview-expanded
getNestedClasses	get-nested-classes
getNestedObject	get-nested-object
getNetbeansStartIdx	get-netbeans-start-idx
getNewType	get-new-type
getNewUUID	get-new-uuid
getNextIjCommand	get-next-ij-command
getNextPrefix	get-next-prefix
getNextTaskTime	get-next-task-time
getNoFocusSelectionForeground	get-no-focus-selection-foreground
getNoSuchMessageExceptionDescription	get-no-such-message-exception-description
getNodeSize	get-node-size
getNonJtaDataSource	get-non-jta-data-source
getNonPluginEntries	get-non-plugin-entries
getNonTranslated	get-non-translated
getNotProxyHosts	get-not-proxy-hosts
getNotificationID	get-notification-id
getNullScaler	get-null-scaler
getNullSetEventHandlers	get-null-set-event-handlers
getNullVarchar	get-null-varchar
getNumberOfImportsAdded	get-number-of-imports-added
getNumberOfImportsRemoved	get-number-of-imports-removed
getNumericPath	get-numeric-path
getOCSPProperties	get-ocsp-properties
getORBList	get-orb-list
getObjectArrayMinLength	get-object-array-min-length
getObjectClassId	get-object-class-id
getObjectClasses	get-object-classes
getObjectContributors	get-object-contributors
getObjectNameFromArguments	get-object-name-from-arguments
getObjectRelatedVariables	get-object-related-variables
getOldChildStale	get-old-child-stale
getOldNodes	get-old-nodes
getOldStartDate	get-old-start-date
getOldest	get-oldest
getOneRowAtATime	get-one-row-at-a-time
getOnlyConstructor	get-only-constructor
getOptimizeTimeInMillis	get-optimize-time-in-millis
getOptionGlobals	get-option-globals
getOptionStrings	get-option-strings
getOptionalArgs	get-optional-args
getOptionsDefault	get-options-default
getOrCreateCallbacksObject	get-or-create-callbacks-object
getOrderedProperties	get-ordered-properties
getOriginDesc	get-origin-desc
getOriginalGraph	get-original-graph
getOriginalGroupName	get-original-group-name
getOut	get-out
getOutFrame	get-out-frame
getOutputArcs	get-output-arcs
getOutputArea	get-output-area
getOutputClassFileName	get-output-class-file-name
getOutputMessage	get-output-message
getOutputParamType	get-output-param-type
getOutputStringForInvalidDocument	get-output-string-for-invalid-document
getOverridableTabListPropertySection	get-overridable-tab-list-property-section
getOverridingMethodComment	get-overriding-method-comment
getOwnHorizontalAlignment	get-own-horizontal-alignment
getOwnXAxisLineColor	get-own-x-axis-line-color
getPackageFilters	get-package-filters
getPad	get-pad
getPageBreakInside	get-page-break-inside
getPageResolution	get-page-resolution
getPageSizeFromPreference	get-page-size-from-preference
getPageStatus	get-page-status
getPageTargetClass	get-page-target-class
getPaletteFromTopComponent	get-palette-from-top-component
getPaletteTooltipValue	get-palette-tool-tip-value
getPan	get-pan
getParameterIndex	get-parameter-index
getParameterTypeId	get-parameter-type-id
getParameterizations	get-parameterizations
getParametersInjectors	get-parameters-injectors
getParentSubpackage	get-parent-subpackage
getPasswordKey	get-password-key
getPasswordLog	get-password-log
getPathInfo	get-path-info
getPdu	get-pdu
getPen	get-pen
getPerfLog	get-perf-log
getPersistable	get-persistable
getPersistenceTypeTextField	get-persistence-type-text-field
getPersistentFieldNames	get-persistent-field-names
getPersistentSet	get-persistent-set
getPersistentUrl	get-persistent-url
getPid	get-pid
getPings	get-pings
getPix	get-pix
getPlastic	get-plastic
getPlatformSuffix	get-platform-suffix
getPlayersOfTeam	get-players-of-team
getPlotOutlinePaint	get-plot-outline-paint
getPluginsChangeStamp	get-plugins-change-stamp
getPointValue	get-point-value
getPos	get-pos
getPositionBelow	get-position-below
getPostcode	get-postcode
getPre	get-pre
getPreLeveledStart	get-pre-leveled-start
getPrerequisiteComponents	get-prerequisite-components
getPrettySignature	get-pretty-signature
getPreviousVisibleSibling	get-previous-visible-sibling
getPreviouslyChoosenWidget	get-previously-choosen-widget
getPrimaryUpdateElements	get-primary-update-elements
getPrincipals	get-principals
getPrivateMenu	get-private-menu
getProceedAction	get-proceed-action
getProcessingInstructionTarget	get-processing-instruction-target
getProducerClassName	get-producer-class-name
getProductCollection	get-product-collection
getProfiledFile	get-profiled-file
getProfilingSettingsStorage	get-profiling-settings-storage
getPrograms	get-programs
getProgress	get-progress
getProhibitedInstallationPathParts	get-prohibited-installation-path-parts
getProjectComboPanel	get-project-combo-panel
getProjectConfiguration	get-project-configuration
getProjectFiles	get-project-files
getProjectHeader	get-project-header
getProjectItemsChangeListeners	get-project-items-change-listeners
getProjectname	get-projectname
getPropertiesSpecific	get-properties-specific
getPropertyImpl	get-property-impl
getPropertyIndexOrNull	get-property-index-or-null
getPropertyInfo	get-property-info
getPropertySheet	get-property-sheet
getPropertyValuesWithOptimizer	get-property-values-with-optimizer
getProtectionLevel	get-protection-level
getProtocolSendRate	get-protocol-send-rate
getProxy2idePort	get-proxy-2-ide-port
getProxyHttpHost	get-proxy-http-host
getPty	get-pty
getPublicHolidayTimeBackgroundColor	get-public-holiday-time-background-color
getPublishingEventQNames	get-publishing-event-q-names
getPullUpRefactoringProcessor	get-pull-up-refactoring-processor
getPwd	get-pwd
getQOP	get-qop
getQualifierPropery	get-qualifier-propery
getQuietnessOptionFor	get-quietness-option-for
getQuotedValue	get-quoted-value
getRBSView	get-rbs-view
getRDB	get-rdb
getRGB	get-rgb
getRGBAt	get-rgb-at
getRHS	get-rhs
getRSB	get-rsb
getRSS	get-rss
getRTT	get-rtt
getRVA	get-rva
getRandom	get-random
getRangeOfOperands	get-range-of-operands
getRawClasspath	get-raw-classpath
getRawImageType	get-raw-image-type
getRdn	get-rdn
getReadHitCnt	get-read-hit-cnt
getReaderContext	get-reader-context
getRec	get-rec
getRecord	get-record
getRed	get-red
getRef	get-ref
getRefOrMergeString	get-ref-or-merge-string
getRefactoringElementImplementation	get-refactoring-element-implementation
getRefactoringFileLocation	get-refactoring-file-location
getReferencedColumnsDescriptor	get-referenced-columns-descriptor
getReformatBlock	get-reformat-block
getRefreshInterceptor	get-refresh-interceptor
getReg	get-reg
getRegexpFromCache	get-regexp-from-cache
getRegisterGroupText	get-register-group-text
getRegisteredFilters	get-registered-filters
getRegisteredMBeanServer	get-registered-m-bean-server
getRegisteredScope	get-registered-scope
getRel	get-rel
getReleaseNote	get-release-note
getRemainingItems	get-remaining-items
getRemoteFileSupport	get-remotefile-support
getRemoteServiceRelativePath	get-remote-service-relative-path
getRemovedElements	get-removed-elements
getRenderedSource	get-rendered-source
getRep	get-rep
getReplyString	get-reply-string
getReportObject	get-report-object
getReq	get-req
getRequestDemandType	get-request-demand-type
getRequestDemandTypeField	get-request-demand-type-field
getRequestStatus	get-request-status
getRequiredAttribute	get-required-attribute
getRes	get-res
getResizeDenominator	get-resize-denominator
getResolveException	get-resolve-exception
getResourceFromClasspathScrubbedForHTML	get-resource-from-classpath-scrubbed-for-html
getResultElements	get-result-elements
getResultSetExtractor	get-result-set-extractor
getReturnAliasesForTransformer	get-return-aliases-for-transformer
getReuseEditorMatchFlags	get-reuse-editor-match-flags
getRev	get-rev
getRevisionFilter	get-revision-filter
getRhs	get-rhs
getRid	get-rid
getRightUnit	get-right-unit
getRootClassNames	get-root-class-names
getRootInterface	get-root-interface
getRotationValue	get-rotation-value
getRow	get-row
getRowCount	get-row-count
getRowGroupsList	get-row-groups-list
getRubyThreadGroup	get-ruby-thread-group
getRulesArray	get-rules-array
getRun	get-run
getRunAsDescriptionTF	get-run-as-description-tf
getRunProperty	get-run-property
getSAN	get-san
getSEI	get-sei
getSFS	get-sfs
getSID	get-sid
getSPI	get-spi
getSQL	get-sql
getSQLHistory	get-sql-history
getSSLCertificateFile	get-ssl-certificate-file
getSVG	get-svg
getSW1	get-sw1
getSW2	get-sw2
getSampleNode	get-sample-node
getSat	get-sat
getSaveProjectAsAction	get-save-project-as-action
getSavedOopResult	get-saved-oop-result
getSchemas	get-schemas
getSchemes	get-schemes
getScm	get-scm
getScmFeatureName	get-scm-feature-name
getScopeDescNearDbg	get-scope-desc-near-dbg
getScriptLimit	get-script-limit
getScrollLock	get-scroll-lock
getSecondLevelCacheEnabled	get-second-level-cache-enabled
getSecondaryPlatform	get-secondary-platform
getSecurityMechanisms	get-security-mechanisms
getSelectableFields	get-selectable-fields
getSelectedBaseRevision	get-selected-base-revision
getSelectedIcon	get-selected-icon
getSelectedMethods	get-selected-methods
getSelectedPortOwnerName	get-selected-port-owner-name
getSelectedRecords	get-selected-records
getSelectedSchema	get-selected-schema
getSelectedSpecs	get-selected-specs
getSelectionValues	get-selection-values
getSelections	get-selections
getSendErrorToClient	get-send-error-to-client
getSeq	get-seq
getSerialFieldWriter	get-serial-field-writer
getSerializerFactory	get-serializer-factory
getServerLibraryName	get-server-library-name
getServerTypeName	get-server-type-name
getServiceClassnamesFromJar	get-service-classnames-from-jar
getServiceComponent	get-service-component
getServiceImplName	get-service-impl-name
getServiceMethodParametersForWeb	get-service-method-parameters-for-web
getServletEditor	get-servlet-editor
getSessionNewCol	get-session-new-col
getSet	get-set
getSetterMethod	get-setter-method
getSex	get-sex
getSha	get-sha
getShiftY	get-shift-y
getShortArray	get-short-array
getShortDescription	get-short-description
getShowDetails	get-show-details
getShowPropertiesValue	get-show-properties-value
getSid	get-sid
getSig	get-sig
getSignedCert	get-signed-cert
getSingleArrayKlassObj	get-single-array-klass-obj
getSingleLocaleEncodingMappingList	get-single-locale-encoding-mapping-list
getSiteSelection	get-site-selection
getSnippets	get-snippets
getSourceBundleLocation	get-source-bundle-location
getSourceField	get-source-field
getSourceGroupForCategory	get-source-group-for-category
getSourceLinkToolTip	get-source-link-tool-tip
getSourceResource	get-source-resource
getSpecificationFactory	get-specification-factory
getSpeedManager	get-speed-manager
getSpi	get-spi
getSplashWidth	get-splash-width
getSplitQRYDTA	get-split-qrydta
getSprintManager	get-sprint-manager
getSql	get-sql
getSqlResultSetMappings	get-sql-result-set-mappings
getSqlXmlUtil	get-sql-xml-util
getSrc	get-src
getSsl	get-ssl
getStackTraceAsStringArray	get-stack-trace-as-string-array
getStartChatAction	get-start-chat-action
getStartListener	get-start-listener
getStateAsText	get-state-as-text
getStateLabel	get-state-label
getStateObject	get-state-object
getStatefulSessionEJBLocalObject	get-stateful-session-ejb-local-object
getStaticPart	get-static-part
getStatusBar	get-status-bar
getStatusFor	get-status-for
getStatusLine	get-status-line
getStatusList	get-status-list
getStatusMessage	get-status-message
getStippled	get-stippled
getStoreOpcode	get-store-opcode
getStrikethroughThickness	get-strikethrough-thickness
getStringContent	get-string-content
getStringData	get-string-data
getStringOrNull	get-string-or-null
getStructureModel	get-structure-model
getStubCType	get-stub-c-type
getStyledTextParser	get-styled-text-parser
getSubClassInstance	get-sub-class-instance
getSubProjectOutputLocations	get-sub-project-output-locations
getSubTaskMessage	get-sub-task-message
getSubactivityState	getsub-activity-state
getSuccessorTask	get-successor-task
getSuggestionType	get-suggestion-type
getSuggestionsTreeModel	get-suggestions-tree-model
getSuiteTypeName	get-suite-type-name
getSum	get-sum
getSun	get-sun
getSunApplicationPublicId	get-sun-application-public-id
getSunGraphicsEnvironment	get-sun-graphics-environment
getSuperclassDescriptor	get-superclass-descriptor
getSupportedJvms	get-supported-jvms
getSupportedRubyVersion	get-supported-ruby-version
getSupportedVariants	get-supported-variants
getSymbolName	get-symbol-name
getSynchronizationActionContext	get-synchronization-action-context
getSyntaxParser	get-syntax-parser
getSystemLocaleValue	get-system-locale-value
getSystemProperties	get-system-properties
getSystemRoot	get-system-root
getTCL	get-tcl
getTCP	get-tcp
getTLS	get-tls
getTOA	get-toa
getTRC	get-trc
getTTL	get-ttl
getTTY	get-tty
getTab	get-tab
getTabRunIndent	get-tab-run-indent
getTag	get-tag
getTargetBinding	get-target-binding
getTargetHandler	get-target-handler
getTargetJava	get-target-java
getTargetLocation	get-target-location
getTargetMethod	get-target-method
getTargetStartMethodArgument	get-target-start-method-argument
getTax	get-tax
getTempWorkingDir	get-temp-working-dir
getTempdir	get-tempdir
getTemplateCount	get-template-count
getTemplateEngine	get-template-engine
getTemplateparameters	get-template-parameters
getTestResource	get-test-resource
getTextFieldValidator	get-text-field-validator
getTextFontFamily	get-text-font-family
getTextLocationFromOffset	get-text-location-from-offset
getTgt	get-tgt
getThisClassFileURL	get-this-class-file-url
getThrottleDelay	get-throttle-delay
getThu	get-thu
getThunkEndOffset	get-thunk-end-offset
getThunkLength	get-thunk-length
getTie	get-tie
getTimeMillis	get-time-millis
getTimePeriodExpression	get-time-period-expression
getTimeRenderer	get-time-renderer
getTip	get-tip
getToType	get-to-type
getToc	get-toc
getToolTipShift	get-tool-tip-shift
getTooltipID	get-tooltip-id
getTop	get-top
getToplevelWindow	get-toplevel-window
getTotalIllegalRefCount	get-total-illegal-ref-count
getTpc	get-tpc
getTraceStart	get-trace-start
getTracingFileArgument	get-tracing-file-argument
getTrackedConnectionAssociator	get-tracked-connection-associator
getTrackerKey	get-tracker-key
getTransformAsText	get-transform-as-text
getTransformInstances	get-transform-instances
getTrapCommunities	get-trap-communities
getTreeLocationOffset	get-tree-location-offset
getTreeYOffset	get-tree-y-offset
getTtl	get-ttl
getTty	get-tty
getTue	get-tue
getTuplizer	get-tuplizer
getTvfStream	get-tvf-stream
getTxFromConfig	get-tx-from-config
getTxt	get-txt
getTypeArgumentsNode	get-type-arguments-node
getTypeBody	get-type-body
getTypeImage	get-type-image
getTypeScope	get-type-scope
getUCP	get-ucp
getUDP	get-udp
getUID	get-uid
getUIs	get-uis
getURI	get-uri
getURL	get-url
getUSN	get-usn
getUTF	get-utf
getUid	get-uid
getUnauthorizedComponentInstantiationListener	get-unauthorized-component-instantiation-listener
getUnconfiguredFeatures	get-unconfigured-features
getUnderlyingObject	get-underlying-object
getUndoModificationStamp	get-undo-modification-stamp
getUninstallationWarnings	get-uninstallation-warnings
getUniquename	get-uniquename
getUniqueness	get-uniqueness
getUnsafeStringParameter	get-unsafe-string-parameter
getUpdateEventListeners	get-update-event-listeners
getUpdatedProjectProperties	get-updated-project-properties
getUpdaterNamespace	get-updater-namespace
getUri	get-uri
getUrl	get-url
getUrlAfterExtraction	get-url-after-extraction
getUse	get-use
getUseEffective	get-use-effective
getUseProfilingPoints	get-use-profiling-points
getUsedNames	get-used-names
getUserAppData	get-user-app-data
getUserInitFileName	get-user-init-file-name
getUserTokenManager	get-user-token-manager
getUsmKeyHandler	get-usm-key-handler
getUtf8Octets	get-utf8-octets
getVAC	get-vac
getVFS	get-vfs
getVMArguments	get-vm-arguments
getVMTelemetryModels	get-vm-telemetry-models
getVOB	get-vob
getVSB	get-vsb
getVac	get-vac
getVal	get-val
getValidUserType	get-valid-user-type
getValidatedSession	get-validated-session
getValueThreeDepthZeroOrNil	get-value-three-depth-zero-or-nil
getValuesFromConfig	get-values-from-config
getVar	get-var
getViewDescriptor	get-view-descriptor
getViewerComparator	get-viewer-comparator
getViewerElementData	get-viewer-element-data
getVisibleReservations	get-visible-reservations
getVmOptionsKey	get-vm-options-key
getWAClassLoader	get-wa-class-loader
getWBS	get-wbs
getWagonProvider	get-wagon-provider
getWantItNowPost	get-want-it-now-post
getWebServiceGroup	get-web-service-group
getWheelXOrigin	get-wheel-x-origin
getWicketPortletProperties	get-wicket-portlet-properties
getWindowResultSet	get-window-result-set
getWordType0	get-word-type-0
getWorkingSetSyncInfoSet	get-working-set-sync-info-set
getWorkspaceFile	get-work-spacefile
getWorktimeEnd	get-work-time-end
getWrapIndex	get-wrap-index
getWrapXAResource	get-wrap-xa-resource
getWsdlModel	get-wsdl-model
getX500Principal	get-x500-principal
getXATerminator	get-xa-terminator
getXAxisLineColor	get-x-axis-line-color
getXaDataSourceClass	get-xa-data-source-class
getYCC	get-ycc
getYearlyRelativeDay	get-yearly-relative-day
getZZPushBackPosition	get-zz-push-back-position
get_countlock	get-countlock
get_incoming_target_name	get-incoming-target-name
get_left_nondeleted_rowcnt	get-left-nondeleted-rowcnt
getmodule	get-module
getname	get-name
getnext	get-next
getreadOnly	getread-only
gg	gg
gnome_vfs_url_show	gnome-vfs-url-show
go	go
goMonitorDeadlock	go-monitor-dead-lock
gobbleComments	gobble-comments
gotCompoundComponent	got-compound-component
graphManager	graph-manager
greaterEqualStringFromParameter	greater-equal-string-from-parameter
gt	gt
gtk_day_selected_double_click	gtk-day-selected-double-click
gtk_entry_set_activates_default	gtk-entry-set-activates-default
gtk_page_setup_set_bottom_margin	gtk-page-setup-set-bottom-margin
gtk_widget_get_style	gtk-widget-get-style
guessDownloadLimit	guess-download-limit
gwtLogoThumb	gwt-logo-thumb
h	h
h1	h-1
h2	h-2
h3	h-3
h4	h-4
h5	h-5
handleAddStepAction	handle-add-step-action
handleBundleActivationPolicyCompletion	handle-bundle-activation-policy-completion
handleCSICommand	handle-csi-command
handleChannelTell	handle-channel-tell
handleClientMessage	handle-client-message
handleConfigurationError	handle-configuration-error
handleCreatePasteTypes	handle-create-paste-types
handleCrossContextSessions	handle-cross-context-sessions
handleInsertVariable	handle-insert-variable
handleLogfile	handle-logfile
handleMapChange	handle-map-change
handleMetadataModelException	handle-meta-data-model-exception
handleOpen	handle-open
handleResolvedCritics	handle-resolved-critics
handleSelectionChange	handle-selection-change
handleTableEditorFocusLost	handle-table-editor-focus-lost
handleTargetSaveableChange	handle-target-saveable-change
handleVisibleDocumentChanged	handle-visible-document-changed
hasAProjectTaskDescendant	has-a-project-task-descendant
hasAcceptedLicenses	has-accepted-licenses
hasBinaryContent	has-binary-content
hasComputed	has-computed
hasContributorsFor	has-contributors-for
hasDeserializationMethod	has-deserialization-method
hasEditorAreaVisibleView	has-editor-area-visible-view
hasEmbeddedParameters	has-embedded-parameters
hasErrorOccurred	has-error-occurred
hasHiddenConstructorArg	has-hidden-constructor-arg
hasInformation	has-information
hasLocalChanges	has-local-changes
hasMenuShortcut	has-menu-shortcut
hasMoreToken	has-more-token
hasNameValuePairs	has-name-value-pairs
hasPlatformFilterError	has-platform-filter-error
hasPrivateChanges	has-private-changes
hasPrivateMod	has-private-mod
hasProcessedImport	has-processed-import
hasProjects	has-projects
hasRecentFiles	has-recent-files
hasResults	has-results
hasSerialVersionUID	has-serial-version-uid
hasShortcut	has-shortcut
hasSizeFlag	has-size-flag
hasStaticMemberTypes	has-static-member-types
hasTorrentChange	has-torrent-change
hasUnusableContentViewer	has-unusable-content-viewer
hasValidSuffix	has-valid-suffix
hasWithParams	has-with-params
hasattr	has-attr
heapViewPreferredSize	heap-view-preferred-size
hexValue	hex-value
hgExecutable	hg-executable
hh	hh
hideAllColumns	hide-all-columns
hideCellTipAlways	hide-cell-tip-always
hidePopupMenu	hide-popup-menu
hitTestChar	hit-test-char
hr	hr
i	i
ic	ic
id	id
identifierToXMLName	identifier-to-xml-name
ifStatement	if-statement
ignoreContainsSyntax	ignore-contains-syntax
ii	ii
illegalControlCharacter	illegal-control-character
illegalException	illegal-exception
im	im
immediateLoad	immediate-load
implRead	impl-read
implementors0	implementors-0
implementsSerializable	implements-serializable
importOne	import-one
importStatic	import-static
importTPC	import-tpc
importURL	import-url
in	in
inNative	in-native
includesLine	includes-line
incrAttempts	incr-attempts
increaseArray	increase-array
incrementErrorCount	increment-error-count
incrementOptimisticFailureCount	increment-optimistic-failure-count
indentNonBlockStatement	indent-non-block-statement
indentOut	indent-out
indexAtLocation	index-at-location
indexGlobal	index-global
indexType	index-type
informUser	inform-user
initBuilder	init-builder
initComp	init-comp
initCopy	init-copy
initCore	init-core
initDeserializedWindow	init-deserialized-window
initEntry	init-entry
initErrors	init-errors
initIcons	init-icons
initItems	init-items
initLayer	init-layer
initQualifiedName	init-qualified-name
initRegistry	init-registry
initSegmentName	init-segment-name
initStaticFunctions	init-static-functions
initStrategies	init-strategies
initSubclassPropertyAliasesMap	init-subclass-property-aliases-map
initUIDefaults	init-ui-defaults
initView	init-view
initialHostIsLocal	initial-host-is-local
initialReconcile	initial-reconcile
initializeBundleManifestLocations	initialize-bundle-manifest-locations
initializeDefaultColors	initialize-default-colors
initializeExplicitSelectClause	initialize-explicit-select-clause
initializeForeignKeyFields	initialize-foreign-key-fields
initializeFromPreferences	initialize-from-preferences
initializeSettingsChangeListener	initialize-settings-change-listener
initializeTypeExtras	initialize-type-extras
initializeVariables	initialize-variables
initiateClosing	initiate-closing
injectConfigurationContainer	inject-configuration-container
injectListeners	inject-listeners
inlineMethod	inline-method
inlineValue	inline-value
insertAll	insert-all
insertColumnButtonActionPerformed	insert-column-button-action-performed
insertEntry	insert-entry
insertImageToken	insert-image-token
insertImpl	insert-impl
insertInfo	insert-info
insertInto	insert-into
insertMarks	insert-marks
insertPosition	insert-position
insertToType	insert-to-type
insideSeeTag	inside-see-tag
inspectStruct	inspect-struct
installDeferredBreakpoints	install-deferred-breakpoints
installLocalAsynchronously	install-local-asynchronously
installModelProxies	install-model-proxies
installTabContainer	install-tab-container
installWheelHandler	install-wheel-handler
installationFinished	installation-finished
instanceForCookie	instance-for-cookie
instance___isub__	instance-isub
instantSubstitution	instant-substitution
instrumentPutLineAndBranchNumbers	instrument-put-line-and-branch-numbers
intDivide	int-divide
int___and__	int-and
int___long__	int-long
int___pow__	int-pow
internalCollapseToLevel	internal-collapse-to-level
internalDoPluginActivation	internal-do-plugin-activation
internalFrameDeactivated	internal-framede-activated
internalGetCopySources	internal-get-copy-sources
internalGetResolutions	internal-get-resolutions
internalIORToObject	internal-ior-to-object
internalMakeMethodBinding	internal-make-method-binding
internalNamePropertyFactory	internal-name-property-factory
internalPerform	internal-perform
internalReadState	internal-read-state
internalRotate	internal-rotate
invalidateFileAndPreprocState	invalidate-file-and-preproc-state
invalidateScreenLineRange	invalidate-screen-line-range
invalidateTextPresentation	invalidate-text-presentation
invalidateTransform	invalidate-transform
invokeChar	invoke-char
invokeInvoker	invoke-invoker
invokeMainGBean	invoke-main-g-bean
invokeOnResponse	invoke-on-response
invoke_ex	invoke-ex
io	io
is	is
is16VMOrGreater	is-16vm-or-greater
isADestroyAction	is-a-destroy-action
isAbort	is-abort
isAbove	is-above
isAcceptableLocation	is-acceptable-location
isAddSubfoldersSelected	is-add-subfolders-selected
isAffects	is-affects
isAll_local	is-all-local
isAnnotatedBy	is-annotated-by
isApplicationRunning	is-application-running
isAssertComplete	is-assert-complete
isAssignableChild	is-assignable-child
isAtBottomLimit	is-at-bottom-limit
isAtLocalVariableStart	is-at-local-variable-start
isAttrFlagSet	is-attr-flag-set
isBitTypeId	is-bit-type-id
isBlueprintTheme	is-blue-print-theme
isBodyTagSupport	is-body-tag-support
isBooleanValue	is-boolean-value
isBridgedCandidateFor	is-bridged-candidate-for
isCVQualifier	is-cv-qualifier
isCaptionLine	is-caption-line
isCaretInsideTag	is-caret-inside-tag
isCaretMarker	is-caret-marker
isCascadeDeleteEnabled	is-cascade-delete-enabled
isCaught	is-caught
isCharString	is-char-string
isCheckInComments	is-check-in-comments
isClassPathCorrect	is-class-path-correct
isClassVariable	is-class-variable
isClasspathBroken	is-classpath-broken
isClipLeft	is-clip-left
isCompatible	is-compatible
isComposedTextAttributeDefined	is-composed-textattribute-defined
isComposite	is-composite
isConstraint	is-constraint
isContentMergableWith	is-content-mergable-with
isContinuation	is-continuation
isCoordDisabled	is-coord-disabled
isCreateTasks	is-create-tasks
isCrossContext	is-cross-context
isCurrentlyParsingFor	is-currently-parsing-for
isCustomTarget	is-custom-target
isDataBuffered	is-data-buffered
isDataVersionAcceptable	is-data-version-acceptable
isDateValue	is-date-value
isDefaultAction	is-default-action
isDefinedType	is-defined-type
isDereferencedBySuperclassProperty	is-dereferenced-by-superclass-property
isDirty	is-dirty
isDisableCookies	is-disable-cookies
isDynamicLayoutSupportedNative	is-dynamic-layout-supported-native
isEcho	is-echo
isEdge	is-edge
isEdit	is-edit
isEditorDisposed	is-editor-disposed
isEditorTopComponent	is-editor-top-component
isEquivalentNode	is-equivalent-node
isEventDisabled	is-event-disabled
isEvictable	is-evictable
isExposeNativeEntityManager	is-expose-native-entity-manager
isFileSystem	is-file-system
isFileSystemRoot	is-file-system-root
isFinalCased	is-final-cased
isFinalizeMethod	is-finalize-method
isFlatLayoutSupported	is-flat-layout-supported
isForTable	is-for-table
isForced	is-forced
isForest	is-forest
isFriendMethod	is-friend-method
isFromHgRepository	is-from-hg-repository
isFullMode	is-full-mode
isFullScrapeEnabled	is-full-scrape-enabled
isGenericGetMethod	is-generic-get-method
isGroupingUsed	is-grouping-used
isHeaderTransparent	is-header-transparent
isHistogram	is-histogram
isHostName	is-host-name
isIgnoreConsistencyProblems	is-ignore-consistency-problems
isIgnoringBreakpoints	is-ignoring-breakpoints
isImplicitConstructor	is-implicit-constructor
isInCvsIgnore	is-in-cvs-ignore
isInDocumentModel	is-in-document-model
isInElementContent	is-in-element-content
isInInitializer	is-in-initializer
isInJavaAnnotationModel	is-in-java-annotation-model
isInLoadPath	is-in-loadpath
isInPermGen	is-in-perm-gen
isInRelationService	is-in-relation-service
isInSecondPass	is-in-second-pass
isInaccessibleOutsideOuterClass	is-inaccessible-outside-outer-class
isInsertCallable	is-insert-callable
isInsideBreakable	is-inside-breakable
isInsideForEachExpression	is-inside-for-each-expression
isIntersectionType	is-intersection-type
isIntroInWindow	is-intro-in-window
isInvalidParameterException	is-invalid-parameter-exception
isInvalidatedIdentifier	is-invalidated-identifier
isInverseCollectionNoOrphanDelete	is-inverse-collection-no-orphan-delete
isIsolated	is-isolated
isJPAAttrAnnotation	is-jpa-attr-annotation
isJarResource	is-jar-resource
isJarSignatureVeryfied	is-jar-signature-veryfied
isJavaControlPanel	is-java-control-panel
isKeyType	is-key-type
isLayoutSupported	is-layout-supported
isLineEmpty	is-line-empty
isLiteralType	is-literal-type
isLocalPathValid	is-local-path-valid
isLocalRollbackOnly	is-local-rollback-only
isLocalTo	is-local-to
isLocallyActiveAware	is-locally-active-aware
isLowercaseExpandedTerms	is-lowercase-expanded-terms
isMalformed2	is-malformed-2
isMalformed3	is-malformed-3
isMalformed4	is-malformed-4
isMappedServlet	is-mapped-servlet
isMemberFunction	is-member-function
isMinorAxisPreferenceChanged	is-minor-axis-preference-changed
isMissingRequiredThreadGroup	is-missing-required-thread-group
isModuleLegalType	is-module-legal-type
isMoveCompletedEndsBack	is-move-completed-ends-back
isMoveableTrimWidget	is-moveable-trim-widget
isMultiDocument	is-multi-document
isMultiLanguage	is-multi-language
isMyProject	is-my-project
isNFSkippable	is-nf-skippable
isNameTerminator	is-name-terminator
isNamedParameter	is-named-parameter
isNamespaceAlias	is-namespace-alias
isNested	is-nested
isNewSizeOK	is-new-size-ok
isNewTransaction	is-new-transaction
isNoNagVersion	is-no-nag-version
isNoUserFile	is-no-user-file
isNormalAnnotation	is-normal-annotation
isNullOnComplicatedPath	is-null-on-complicated-path
isOGLEnabled	is-ogl-enabled
isOldEncoding	is-old-encoding
isOnSyncQueue	is-on-sync-queue
isOpenBraceLastLineToken	is-open-brace-last-line-token
isOpenQuote	is-open-quote
isOurEntry	is-our-entry
isPackMagic	is-pack-magic
isPackageAlreadyProposed	is-package-already-proposed
isPaletteInToolBar	is-palette-in-tool-bar
isPanelEnabled	is-panel-enabled
isParameterSpecified	is-parameter-specified
isPatternValid	is-pattern-valid
isPerformingEvaluation	is-performing-evaluation
isPlatformDir	is-platform-dir
isPlatformDirectory	is-platform-directory
isPointOfNoReturn	is-point-of-no-return
isPortletRequest	is-portlet-request
isPrefixBreaker	is-prefix-breaker
isPrepared0	is-prepared-0
isPreviousAvailable	is-previous-available
isProgressing	is-progressing
isProgressive	is-progressive
isProject2	is-project-2
isPropagateSAX	is-propagate-sax
isQuirkIESelectPercentWidth	is-quirk-ie-select-percent-width
isRealTimeTaskActive	is-real-time-task-active
isReentrant	is-reentrant
isRegisterable	is-registerable
isResolve	is-resolve
isRotated	is-rotated
isRowSelected	is-rowselected
isRunFileEnabled	is-run-file-enabled
isSCEnabled	is-sc-enabled
isSameDate	is-same-date
isSameFamilyAs	is-same-family-as
isSameSelection	is-same-selection
isScheduledForRestart	is-scheduled-for-restart
isScopeKind	is-scope-kind
isScript	is-script
isScrollable	is-scrollable
isShowColumns	is-show-columns
isShowField	is-show-field
isShowHexValues	is-show-hex-values
isShowInDialog	is-show-in-dialog
isShowRunDialog	is-show-run-dialog
isShowingCallers	is-showing-callers
isSimpleName	is-simple-name
isSkipPackagePrivateClasses	is-skip-package-private-classes
isSomeoneDragging	is-someone-dragging
isSourceAttachmentEqual	is-source-attachment-equal
isSpNegoMech	is-sp-nego-mech
isStableStatus	is-stable-status
isStaticBlock	is-static-block
isSubsampled	is-subsampled
isSuitableAlignment	is-suitable-alignment
isSuiteComponentWizard	is-suite-component-wizard
isSupportedFile	is-supported-file
isTextPatternUsable	is-text-pattern-usable
isThreadContentionMonitoringSupported	is-thread-contention-monitoring-supported
isThrowExceptionIfPropertyNotFound	is-throw-exception-if-property-not-found
isToPrint	is-to-print
isTruncateMode	is-truncate-mode
isTrustedSSLCACertStore	is-trusted-sslca-cert-store
isTrustedSigningCACertStore	is-trusted-signing-ca-cert-store
isTypeAltered	is-type-altered
isTypeVariableSignature	is-type-variable-signature
isUniformSelection	is-uniform-selection
isUnionType	is-union-type
isUpgrade	is-upgrade
isUseColor	is-use-color
isUseHeadIfNotFound	is-use-head-if-not-found
isValidDocumentTypeSystemId	is-valid-document-type-system-id
isValidHexValue	is-valid-hex-value
isValidJsClassName	is-valid-js-class-name
isValidRevision	is-valid-revision
isValidTarget	is-valid-target
isValidType	is-valid-type
isVendorSpecificProperty	is-vendor-specific-property
isVersionOK	is-version-ok
isVersioned	is-versioned
isWatchEditEnabled	is-watch-edit-enabled
isWithinBatch	is-within-batch
isWithinCurrentRange	is-within-current-range
isWsgenSupported	is-wsgen-supported
isXmlLang	is-xml-lang
is_subset_of	is-subset-of
itemKeyChanged	item-key-changed
iteratePlugin	iterate-plugin
ix	ix
jAlignActionB_actionPerformed	j-align-action-b-action-performed
jCbxReqAuthSourceActionPerformed	j-cbx-req-auth-sourc-eaction-performed
javaLengthAt	java-length-at
javaObjectHasField	java-object-has-field
javaRead	java-read
java_class_methods	java-class-methods
javadocBlockCompletion	javadoc-block-completion
javadocComment	javadoc-comment
jkInit	jk-init
jl	jl
jround_up	jround-up
jsFunction_write	js-function-write
js_slice	js-slice
jtsInitError	jts-init-error
keepOldResultTabsChanged	keep-old-result-tabs-changed
keyColumnOnLeft	key-column-on-left
keySetFull	key-set-full
kw	kw
lAlignActionB_actionPerformed	l-align-action-b-action-performed
lFontListen	l-font-listen
languageHierarchy	language-hierarchy
layoutVertical	layout-vertical
lb	lb
lblProjectName	lbl-project-name
le	le
letStart	let-start
li	li
lineSection	line-section
linesInWindow	lines-in-window
linkedByIndex	linked-by-index
listDeploymentTree	list-deployment-tree
listMouseClicked	list-mouse-clicked
listNetworks	list-networks
listValueHasValue	list-value-has-value
listenTarget	listen-target
ln	ln
loadDefaultProperties	load-default-properties
loadInt	load-int
loadJRE	load-jre
loadLib	load-lib
loadLoaderPackage	load-loader-package
loadLog	load-log
loadMRU	load-mru
loadMib	load-mib
loadNames	load-names
loadNil	load-nil
loadProfile	load-profile
loadPropertyDatabaseFromResource	load-property-database-from-resource
loadRegistryComponents	load-registry-components
loadSelectData	load-select-data
loadSelectionHistory	load-selection-history
loadSourceKeyStore	load-source-key-store
loadStudentIds	load-student-ids
loadWSDL	load-wsdl
load_append	load-append
localTime	local-time
localizableFAILED_TO_PARSE_WITH_MEX	localizable-failed-to-parse-with-mex
localizableINTERNALIZER_INCORRECT_VERSION	localizable-internalizer-incorrect-version
localizableLOCALIZED_ERROR	localizable-localized-error
localizableNULL_NAMESPACE_FOUND	localizable-null-namespace-found
localizablePARSING_INVALID_TAG	localizable-parsing-invalid-tag
localizablePARSING_INVALID_URI	localizable-parsing-invalid-uri
localizablePROCESSOR_MISSING_MODEL	localizable-processor-missing-model
localizableVALIDATION_INVALID_ELEMENT	localizable-validation-invalid-element
localizableVALIDATION_MISSING_REQUIRED_SUB_ENTITY	localizable-validation-missing-required-sub-entity
localizableWEBSERVICEAP_INVALID_HANDLERCHAIN_FILE_NOHANDLER_CONFIG	localizable-webservice-ap-invalid-handlerchain-file-nohandler-config
localizableWSDLMODELER_INVALID_PARAMETER_ORDER_INVALID_PARAMETER_ORDER	localizable-wsdl-modeler-invalid-parameter-order-invalid-parameter-order
locateFile	locate-file
locateGenerationContext	locate-generation-context
locatePackageDeclarations	locate-package-declarations
lockGlobally	lock-globally
lockRowOnPage	lock-row-on-page
logAndThrowSQLException	log-and-throw-sql-exception
logCPUInfo	log-cpu-info
logCompleted	log-completed
logPath	log-path
logRemoved	log-removed
logSamples	log-samples
long___invert__	long-invert
lookWithinEmptyBlock	look-within-empty-block
lookbehindHasToken	look-behind-has-token
looksLikeArrayInitializerIntro	looks-like-array-initializer-intro
lookupContentDownload	lookup-content-download
loopVector	loop-vector
lostOwnership	lost-ownership
lowMemory	low-memory
lt	lt
m	m
m1	m-1
m2	m-2
m3	m-3
m4	m-4
makeActive	make-active
makeData	make-data
makeDate	make-date
makeDescriptor	make-descriptor
makeLocationProc	make-location-proc
makeNameClassExcept	make-name-class-except
makeNewClass	make-new-class
makePackageHtml	make-package-html
makePersistent	make-persistent
makePersistentAll	make-persistent-all
makeRecordType	make-record-type
makeStopSet	make-stop-set
makeTree	make-tree
makeUnexpandedNotAllowed	make-unexpanded-not-allowed
mangleNameForPolyImpl	mangle-name-for-poly-impl
mangleURI	mangle-uri
mapAvailableProperties	map-available-properties
mapCerts	map-certs
mapErrorStatus	map-error-status
mapOver	map-over
mapWidget	map-widget
margin	margin
markAs	mark-as
markAsApplicationClass	mark-as-application-class
markAsSelected	mark-as-selected
markBB	mark-bb
markIgnoreNextCaretUpdate	mark-ignore-next-caret-update
markInitialSize	mark-initial-size
markRecognized	mark-recognized
markRevealDelta	mark-reveal-delta
matchAnnotation	match-annotation
matchArray	match-array
matchCerts	match-certs
matchEnum	match-enum
matchUsageProblem	match-usage-problem
matchesExactly	matches-exactly
matchesRuntimeType	matches-runtime-type
matchesTargetPatternBreakpoint	matches-target-pattern-breakpoint
maybeMakeTempAssignment	maybe-make-temp-assignment
maybeParseTypeVariableList	maybe-parse-type-variable-list
maybeSystemExit	maybe-system-exit
me	me
meetInto	meet-into
mejbStartRecursive	mejb-start-recursive
membershipChanged	membership-changed
mergeAdobeNode	merge-adobe-node
mergeIU	merge-iu
mergeIn	merge-in
mergeInitialize	merge-initialize
mergeNull	merge-null
messageDataReceived	message-data-received
militaryTime	military-time
minMax	min-max
minimumNumberOfThreads	minimum-number-of-threads
missingEnumValue	missing-enum-value
missingValueForAnnotationMember	missing-value-for-annotation-member
mm	mm
modelNormalInstruction	model-normal-instruction
modifiedAttrValue	modified-attr-value
modifyButtonActionPerformed	modify-button-action-performed
modifyModifiersAnnotation	modify-modifiers-annotation
mouseHoverProc	mouse-hover-proc
moveChosenDown	move-chosen-down
ms	ms
msec	msec
msgLoad	msg-load
mtTestCase	mt-test-case
mult	mult
multiRun	multi-run
multiplyByPositiveInt	multiply-by-positive-int
mungeFieldHost	munge-field-host
mv	mv
n	n
nGetMessages	n-get-messages
nOpenRmfSequencer	n-open-rmf-sequencer
namedFrameShown	named-frame-shown
native_get_xthickness	native-get-xthickness
native_paint_handle	native-paint-handle
nbfsURLStreamHandler	nbfs-url-stream-handler
ne	ne
needStatistics	need-statistics
needsBreak	needs-break
needsSwdpLibrary	needs-swdp-library
nestLabel	nest-label
newAgent_	new-agent
newBClass	new-b-class
newCallClosure	new-call-closure
newClassDoc	new-class-doc
newCmpField	new-cmp-field
newCommandKey	new-command-key
newCompiledBlockLight	new-compiled-block-light
newDelta	new-delta
newEnumConstantDeclaration	new-enum-constant-declaration
newExecutionContext	new-execution-context
newFileItemFactory	new-file-item-factory
newInvocationHandler	new-invocation-handler
newLoadObjectUnloadEvent	new-load-object-unload-event
newLocalProcessBuilder	new-local-process-builder
newMessageSecurity	new-message-security
newNamespace	new-namespace
newPagingNavigationLink	new-paging-navigation-link
newProject	new-project
newProjectItemActionPerformed	new-project-item-action-performed
newRule	new-rule
newSAXParserFactory	new-sax-parser-factory
newScheduledThreadPool	new-scheduled-thread-pool
new_rational	new-rational
nextFlaggedToken	next-flagged-token
nextLeaf	next-leaf
nextLine	next-line
nextList	next-list
nextPageId	next-page-id
nextRandom	next-random
nl	nl
no	no
noAspectBoundExceptionInit	no-aspect-bound-exception-init
noClientWcharCodesetCtx	no-client-wchar-codeset-ctx
noSuchService	no-such-service
noUsableProfile2	no-usable-profile-2
noUsableProfile3	no-usable-profile-3
nodeInsert	node-insert
nonLLStarDecision	non-ll-star-decision
nonNullTypes	non-null-types
nonSupportedTypeColumn	non-supported-type-column
normaliseJDK	normalise-jdk
normalizeFiles	normalize-files
normalizePort	normalize-port
normalizedPath	normalized-path
notAValueoutputstream	not-a-value-output-stream
notifyBuildNeeded	notify-build-needed
notifyCannotOpen	notify-cannot-open
notifyDequeueEventSet	notify-dequeue-event-set
notifyModifyClasspath	notify-modify-classpath
notifyProgressDone	notify-progress-done
notifyRegistered	notify-registered
notifySearchCancelled	notify-search-cancelled
notifySearchFinished	notify-search-finished
notifyStatusChange	notify-status-change
ns	ns
nullToPrimitiveTest	null-to-primitive-test
numParameters	num-parameters
o	o
oa	oa
objectId	object-id
objectOf	object-of
objectsAdjacent	objects-adjacent
obtainFreshBeanFactory	obtain-freshbean-factory
of	of
ok	ok
okBtnActionPerformed	ok-btn-action-performed
okToChange	ok-to-change
ol	ol
omitNorms	omit-norms
on	on
onCertFileChange	on-cert-file-change
onChildDeleted	on-child-deleted
onCompileSingleStep	on-compile-single-step
onDirectoryDelete	on-directory-delete
onDragMove	on-drag-move
onErrorNotification	on-error-notification
onExportFilenameBrowseClick	on-export-file-name-browse-click
onFinish	on-finish
onMouse	on-mouse
onNextInnerView	on-next-inner-view
onOlderClicked	on-older-clicked
onSignOutClicked	on-sign-out-clicked
op	op
opElementAsgnWithOrPartTwoNArgs	op-element-asgn-with-or-part-two-n-args
openAtElement	open-at-element
openDependencies	open-dependencies
openForwardsFlushedScan	open-forwards-flushed-scan
openRenameDialog	open-rename-dialog
openSearchResults	open-search-results
or	or
originalChanged	original-changed
originalSupport	original-support
outDefined	out-defined
outermostClass	outermost-class
outputDone	output-done
outputToResultTree	output-to-result-tree
outputWidth	output-width
overlapsBlockBorders	overlaps-block-borders
overlapsGuardedBlocks	overlaps-guarded-blocks
overridingMethods	overriding-methods
overviewRulerContextMenuAboutToShow	overview-ruler-context-menu-about-to-show
ownNode	own-node
p	p
pF	pf
pI	pi
pM	pm
pO	po
pSetScrollbarBackground	p-set-scrollbar-background
pacificKosrae	pacific-kosrae
packetReceiveManager	packet-receive-manager
pageDetails	page-details
paintAnnotation	paint-annotation
paintBackgroundDefaultAndFocused	paint-background-default-and-focused
paintDesktopIconBackground	paint-desktop-icon-background
paintDragWindow	paint-drag-window
paintLandmarkInfo	paint-landmark-info
paintPoolBar	paint-pool-bar
paintRadioButtonBackground	paint-radio-button-background
paintRadioButtonMenuItemArrowIcon	paint-radio-button-menu-item-arrow-icon
paintXPComboBoxBackground	paint-xp-combo-box-background
parseAndBuildBindings	parse-and-build-bindings
parseArchetypeDescriptor	parse-archetype-descriptor
parseCMDNSPRM	parse-cmdnsprm
parseCUpart	parse-c-upart
parseConfigurationElementAttributes	parse-configuration-element-attributes
parseDefinitionsNoImport	parse-definitions-no-import
parseDescribeError	parse-describe-error
parseEXCSQLIMM	parse-excsqlimm
parseError	parse-error
parseEscapeIntoBuffer	parse-escape-into-buffer
parseFeature	parse-feature
parseFileItems	parse-file-items
parseFileMain	parse-file-main
parseHighlight	parse-highlight
parseLaunchingPreferences	parse-launching-preferences
parseMnemonics	parse-mnemonics
parseNumbers	parse-numbers
parsePackagedFeature	parse-packaged-feature
parsePartOfMultiGuardedSection	parse-part-of-multi-guarded-section
parsePortTypeOperationOutput	parse-port-type-operation-output
parseRemote	parse-remote
parseSQLRSROW	parse-sqlrsrow
parseScript	parse-script
parseSetProperty	parse-set-property
parseStack	parse-stack
parseStorProcReturnedScrollableRowset	parse-stor-proc-returned-scrollable-rowset
parseSuperClass	parse-super-class
parseWhenScanFinished	parse-when-scan-finished
parseZone	parse-zone
parseZoneMinutes	parse-zone-minutes
pc	pc
pd	pd
peekInMethodFlagAsString	peek-in-method-flag-as-string
perObjectInterfaceField	per-object-interface-field
performCompilation	perform-compilation
performComponentPostInit	perform-component-post-init
performFieldTransformations	perform-field-transformations
persistTrust	persist-trust
persistentDispatch	persistent-dispatch
pf	pf
pi	pi
pingFailed	ping-failed
placeAnimal	place-animal
placeLayoutUndoableEdit	place-layout-undoable-edit
plantFunctionRef	plant-function-ref
poacurrentUnbalancedStack	poa-current-unbalanced-stack
pointsToColumnReference	points-to-column-reference
popInvocationInfo	pop-invocation-info
popMarkForCachingPKGNAMCSN	pop-mark-for-caching-pkgnamcsn
popStack	pop-stack
popState	pop-state
popTriggerExecutionContext	pop-trigger-execution-context
populateWithTriplets	populate-with-triplets
portAttributes	port-attributes
posWithinAnyQuote	pos-within-any-quote
positionAtDoneScanFromClose	position-at-done-scan-from-close
positionControl	position-control
postAttach	post-attach
postCloneNodeEvent	post-clone-node-event
postCreateLocalHome	post-create-local-home
postDelConditional	post-del-conditional
postDelEmpty	post-del-empty
postDelIntLit	post-del-int-lit
postDelWhile	post-del-while
postExtCatch	post-ext-catch
postProcessAction	post-process-action
postProcessBeanDefinition	post-process-bean-definition
postWelcomeFiles	post-welcome-files
postWorkDirectory	post-work-directory
pp	pp
ppRemoveRes_actionPerformed	pp-remove-res-action-performed
pr	pr
preTransform	pre-transform
prefTabSize	pref-tab-size
preferredTabAreaWidth	preferred-tab-area-width
preload	preload
prepareWrapLines	prepare-wrap-lines
presentChooser	present-chooser
previousMonitorInInterpreterFrame	previous-monitor-in-interpreter-frame
printAlias	print-alias
printAllGF	print-allgf
printBaseLocation	print-base-location
printInstanceOfExpression	print-instance-of-expression
printInteger	print-integer
printMessage	print-message
printMethodRef	print-method-ref
printReservation	print-reservation
printScope	print-scope
printTypeDeclaration	print-type-declaration
privCopyFiles	priv-copy-files
procOptionsChanged	proc-options-changed
proceedMethodName	proceed-method-name
processActionParameters	process-action-parameters
processCDATA	process-cdata
processCheatSheetElements	process-cheat-sheet-elements
processColumn	process-column
processCommentAsCharArraySmall	process-comment-as-char-array-small
processConfigurationEvent	process-configuration-event
processDashArg	process-dash-arg
processDataOrFolderCreated	process-data-or-folder-created
processDestinationRepos	process-destination-repos
processDocWrappedMethod	process-doc-wrapped-method
processFiles	process-files
processInstalledBundles	process-installed-bundles
processPSVIMemberTypeDefinitions	process-psvi-member-type-definitions
processPhpUnitError	process-php-unit-error
processProjectLogic	process-project-logic
processPropertyImpl	process-property-impl
processQuery	process-query
processQueue	process-queue
processResourceAdapterWrappers	process-resource-adapter-wrappers
processSeekAdded	process-seek-added
processServerMessage	process-server-message
processSignerInfos	process-signer-infos
processTags	process-tags
processTask	process-task
produceDownloadFile	produce-download-file
promptForInput0	prompt-for-input-0
promptToRefresh	prompt-to-refresh
property___delete__	property-delete
proximityEvent	proximity-event
ps	ps
publishException	publish-exception
pushMetaAwareObject	push-meta-aware-object
pushNull	push-null
pushSubContextList	push-sub-context-list
putBuildFiles	put-build-files
putBuildXMLSourceFile	put-build-xml-source-file
putDimensionForPrinting	put-dimension-for-printing
putJarTypeInfo	put-jar-type-info
putManifestEntry	put-manifest-entry
py	py
q	q
q1	q-1
q2	q-2
q3	q-3
qq	qq
queueCommands	queue-commands
queueDataSources	queue-data-sources
quotedIdentifier	quoted-identifier
r	r
r1	r-1
r2	r-2
r3	r-3
r_check_vowel_harmony	r-check-vowel-harmony
r_stem_noun_suffixes	r-stem-noun-suffixes
raiseSessionRequiredException	raise-session-required-exception
rawInstance	raw-instance
rb	rb
rd	rd
re	re
readAccess	read-access
readAccessCode	read-access-code
readByteBuffer	read-byte-buffer
readChunk	read-chunk
readCodeExpression	read-code-expression
readDigitsInBuffer	read-digits-in-buffer
readEntity	read-entity
readFailureNames	read-failure-names
readFastShort	read-fast-short
readFastUnsignedByte	read-fast-unsigned-byte
readFastUnsignedShort	read-fast-unsigned-short
readFdocaLong	read-fdoca-long
readImagesFromRegistry	read-images-from-registry
readJBoolean	read-j-boolean
readJavaLikeNamesFile	read-java-like-names-file
readLayoutCode	read-layout-code
readMagic	read-magic
readManifestFile	read-manifest-file
readOrderPreference	read-order-preference
readReplyDss	read-reply-dss
readSequence	read-sequence
readSignatureAsUnresolvedType	read-signature-as-unresolved-type
readStatus	read-status
readUtf8Ref	read-utf8-ref
readValueUnderLock	read-value-under-lock
read_lookahead	read-lookahead
readyToCollect	ready-to-collect
recalculate	recalculate
recalculateIfOrientationChanged	recalculate-if-orientation-changed
recheckPeers	recheck-peers
recomputeDropDownItems	recompute-dropdown-items
recordInterTypeMethodDeclarationCode	record-inter-type-method-declaration-code
recordLocatorForType	record-locator-for-type
recordRefvalConflict	record-ref-val-conflict
recordUserInput	record-user-input
redSliderStateChanged	red-slider-state-changed
redirectLocalVariables	redirect-local-variables
redoAnalysis	redo-analysis
refactoringSubclasses	refactoring-subclasses
refreshBrandingEnabled	refresh-branding-enabled
refreshContent	refresh-content
refreshInlineTagPosition	refresh-inline-tag-position
refreshPolicy	refresh-policy
refreshPopup	refresh-popup
refreshSequence	refresh-sequence
refreshShortcuts	refresh-shortcuts
refreshTicksHorizontal	refresh-ticks-horizontal
refreshVersion	refresh-version
registerAlertHandler	register-alert-handler
registerAtStart	register-at-start
registerCatalogEntry	register-catalog-entry
registerClicked	register-clicked
registerClusteringHandler	register-clustering-handler
registerCodeCompletion	register-code-completion
registerCommand	register-command
registerDateTimeFunctions	register-date-time-functions
registerDeploymentRepository	register-deployment-repository
registerKernel	register-kernel
registerNonExists	register-non-exists
registerRefreshProcedure	register-refresh-procedure
registerResolvableDependency	register-resolvable-dependency
registerScheme	register-scheme
registerServerRequestDispatcher	register-server-request-dispatcher
registerSupportForLayout	register-support-for-layout
registerSwitches	register-switches
registerTestEnded	register-test-ended
registerType	register-type
registerVisibleTypes	register-visible-types
regsub	regsub
relativizeFilePaths	relativize-file-paths
releaseCapture	release-capture
releaseReferences	release-references
releaseWritableTile	release-writable-tile
remapDeletes	remap-deletes
rememberIsStart	remember-is-start
removeActivityRegistryListener	remove-activity-registry-listener
removeAddedSoFar	remove-added-so-far
removeAllInstrumentation	remove-all-instrumentation
removeAllocatable	remove-allocatable
removeAlwaysOff	remove-always-off
removeAttributeQuietly	remove-attribute-quietly
removeBatchLoadableEntityKey	remove-batch-loadable-entity-key
removeBuilders	remove-builders
removeCollector	remove-collector
removeConstraint	remove-constraint
removeConvertible	remove-convertible
removeCustomColumnToAllNestedTask	remove-customcolumn-to-all-nested-task
removeDependent	remove-dependent
removeDetailFormatter	remove-detail-formatter
removeDisabledTables	remove-disabled-tables
removeDuplicateEntries	remove-duplicate-entries
removeEndingSlashes	remove-ending-slashes
removeEngine	remove-engine
removeExcludedPolicy	remove-excluded-policy
removeExtendedAttributes	remove-extended-attributes
removeExtendedModifyListener	remove-extended-modify-listener
removeFileSystem	remove-file-system
removeFillerAfter	remove-filler-after
removeHandlerAnnotation	remove-handler-annotation
removeIncomming	remove-incomming
removeInternalPropertyListener	remove-internal-property-listener
removeInterval	remove-interval
removeLogicalStrutures	remove-logical-strutures
removeLowest	remove-lowest
removeMenuKeyListener	remove-menu-key-listener
removeMethodPermission	remove-method-permission
removeModifiedLayouts	remove-modified-layouts
removeMonitorActions	remove-monitor-actions
removeObservableActionListener	remove-observable-action-listener
removePlayer	remove-player
removePool	remove-pool
removePort	remove-port
removePreInstantiateDelegate	remove-pre-instantiate-delegate
removeProfileDeploymentRepository	remove-profile-deployment-repository
removeProp	remove-prop
removeReport	remove-report
removeResB_actionPerformed	remove-res-b-action-performed
removeResourceExtension	remove-resource-extension
removeRoleMapping	remove-role-mapping
removeSatellite	remove-satellite
removeSceneNodeEdges	remove-scene-node-edges
removeScopeStrategy	remove-scope-strategy
removeServerInstanceInternal	remove-server-instance-internal
removeSourceBundle	remove-source-bundle
removeSplitChangeListener	remove-split-change-listener
removeStatementEventListener	remove-statement-event-listener
removeTables	remove-tables
removeTaskListener	remove-task-listener
removeTopComponentFromOtherModes	remove-top-component-from-other-modes
removeTransferListener	remove-transfer-listener
removeUnloadedTopComponent	remove-unloaded-top-component
removeUnsolicited	remove-unsolicited
removeUnusedSections	remove-unused-sections
removeValueChangingListener	remove-value-changing-listener
removeWebBrowserListener	remove-web-browser-listener
removeXmltype	remove-xml-type
renameFilter	rename-filter
renameFolder	rename-folder
renderChild	render-child
renderColumnStyle	render-column-style
renderCommandLine	render-command-line
renderCommandList	render-command-list
renderNames	render-names
renderReportUsingOutputStream	render-report-using-output-stream
renderSelectType	render-select-type
renderValues	render-values
reparseOnEditingFile	reparse-on-editing-file
replaceNewLineWithLineBreak	replace-new-line-with-line-break
replaceUIActionMap	replace-ui-action-map
replaceXpp3DOM	replace-xpp3-dom
reportBinding	report-binding
reportDeferredDiagnostic	report-deferred-diagnostic
reportNotInJavaProjectError	report-not-in-java-project-error
reportProgressBegin	report-progress-begin
requestAttention	request-attention
requestRequiresStub	request-requires-stub
requestView	request-view
requireStructureOptimization	require-structure-optimization
requiresInitialIndent	requires-initial-indent
rescueAndInstantiate	rescue-and-instantiate
resetAlreadyNotified	reset-already-notified
resetAsyncState	reset-async-state
resetElementAndClientId	reset-element-and-client-id
resetRenderers	reset-renderers
resetSlotTable	reset-slottable
resetStringValue	reset-string-value
resizeArray	resiz-earray
resolveBridgedWriteMethod	resolve-bridged-write-method
resolveInBaseClasses	resolve-in-base-classes
resolveInLocalNamespace	resolve-in-local-namespace
resolveNamespaceBfs	resolve-namespace-bfs
resolveQueue	resolve-queue
resolveRefreshCheckDelay	resolve-refresh-check-delay
resolveResourceAdapterName	resolve-resource-adapter-name
resourcePathToHandle	resource-path-to-handle
restoreBuildRoots	restore-build-roots
restoreCombo	restore-combo
restoreCustomPropertyFiles	restore-custom-property-files
restoreEditingState	restore-editing-state
restoreExistingFiles	restore-existing-files
restoreLegacyFilters	restore-legacy-filters
restored	restored
result_type	result-type
retrieveFeature	retrieve-feature
retrieveHandlerConfigFromResource	retrieve-handler-config-from-resource
retrieveIdentifierEndPosition	retrieve-identifier-end-position
retrieveValidatorConfiguration	retrieve-validator-configuration
retryLinkMouseClicked	retry-link-mouse-clicked
reversePrefix	reverse-prefix
rhs_length	rhs-length
rm	rm
rowRefresh	row-refresh
rowsUpdated	rows-updated
rp	rp
runApplication	run-application
runDependenciesListModelRefresh	run-dependencies-list-model-refresh
runParser	run-parser
runScrapes	run-scrapes
runShellClass	run-shell-class
runTempTests	run-temp-tests
runner	runner
s	s
safeInvokeAndWait	safe-invoke-and-wait
sameDirection	same-direction
saveComposedText	save-composed-text
saveLastGoodQuery	save-last-good-query
saveLeaveDelegateSetting	save-leave-delegate-setting
saveMailResourceDatatoXml	save-mail-resource-data-to-xml
saveSelectedFile	save-selected-file
saveTo	save-to
saveWidths	save-widths
save_dict	save-dict
saving	saving
sawInt	saw-int
sawStringIntern	saw-string-intern
scanBinaries	scan-binaries
scanOnTimeout	scan-on-timeout
scanWhitespace	scan-whitespace
scheduleFoldUpdate	schedule-fold-update
scheduleNodeDescriptorForOrdering	schedule-node-descriptor-for-ordering
searchFiles	search-files
searchForSetterMethod	search-for-setter-method
searchPatterns	search-patterns
searchRunnableChildren	search-runnable-children
searchUpdatedTextActionPerformed	search-updated-text-action-performed
securityPrintException	security-print-exception
selectConstructorAndTransformArguments	select-constructor-and-transform-arguments
selectPageFlowSceneElement	select-page-flow-scene-element
selectProposal	select-proposal
selectRowsByInstances	select-rows-by-instances
sendHave	send-have
sendHelo	send-helo
sendPackedMidiMessage	send-packed-midi-message
serializeComponentXml	serialize-component-xml
serverClassAddBreakpoints	server-class-add-breakpoints
setAMText	set-am-text
setAZMessagingEnabled	set-az-messaging-enabled
setActivatedNode	set-activated-node
setActivationConfigProperty	set-activation-config-property
setActivationSpecFactory	set-activation-spec-factory
setAddressAt	set-address-at
setAjax	set-ajax
setAjaxDebugModeEnabled	set-ajax-debug-mode-enabled
setAllDisabled	set-all-disabled
setAllLintIgnored	set-all-lint-ignored
setAllowMergeReincarnations	set-allow-merge-reincarnations
setAllowMultiple	set-allow-multiple
setAmbiguousYear	set-ambiguous-year
setAmpm	set-ampm
setAnimatedDimension	set-animated-dimension
setAnnounceResult	set-announce-result
setApplicationContextPath	set-application-context-path
setAppt	set-appt
setArch	set-arch
setArchives	set-archives
setArchivesFormat	set-archives-format
setArcs	set-arcs
setAsCM	set-ascm
setAsyncSupported	set-async-supported
setAtETag	set-at-e-tag
setAutoDiscoveryTTL	set-auto-discovery-ttl
setAutoOpen	set-auto-open
setAutoPopulateSeriesStroke	set-auto-populate-series-stroke
setAutoPromote	set-auto-promote
setAuxClasspath	set-aux-class-path
setBarVisibility	set-bar-visibility
setBaseItemLabelPaint	set-base-item-label-paint
setBccList	set-bcc-list
setBeanShellReplace	set-bean-shell-replace
setBinding	set-binding
setBlackRating	set-black-rating
setBootstrapLibraries	set-bootstrap-libraries
setBorderLeftWidth	set-border-left-width
setBuiltModulesProperty	set-built-modules-property
setBundleGroupInfos	set-bundle-group-infos
setByteBufferWithInfo	set-byte-buffer-with-info
setCIntegerAt	set-c-integer-at
setCacheFolder	set-cache-folder
setCachedConnectionManagerObjectName	set-cached-connection-manager-object-name
setCalculateProjectFolder	set-calculate-project-folder
setCapabilityExchange	set-capability-exchange
setCaretColor	set-caret-color
setCascadeAll	set-cascade-all
setCatalogsInPrivilegeDefinitions	set-catalogs-inprivilege-definitions
setCategoryIteration	set-category-iteration
setCategoryLabelPositionOffset	set-category-label-position-offset
setCellpadding	set-cell-padding
setCharEnd	set-char-end
setCheckpointAtEndOfMethod	set-checkpoint-at-end-of-method
setChildPropertySetter	set-child-property-setter
setChronology	set-chronology
setClassFilters	set-class-filters
setClassIndex	set-class-index
setClassRequests	set-class-requests
setClearReference	set-clear-reference
setClearToolDir	set-clear-tool-dir
setClickRepeatDelay	set-click-repeat-delay
setClientName	set-client-name
setCloseDisplay	set-close-display
setCloseHandler	set-close-handler
setClosureArguments	set-closure-arguments
setClusterSender	set-clusters-ender
setCollectData	set-collect-data
setColorPrefered	set-color-prefered
setColumnMappings	set-column-mappings
setCommandComboBox	set-command-combo-box
setCompliance	set-compliance
setConnectionFactoryInterfaceClass	set-connection-factory-interface-class
setConnectionFactoryName	set-connection-factory-name
setConnectionImplClass	set-connection-impl-class
setConnectionParameters	set-connection-parameters
setConstraintId	set-constraint-id
setContainerEnabled	set-container-enabled
setContentAndLabelProviders	set-content-and-label-providers
setContentTypeHandlerManager	set-content-type-handler-manager
setControlTemplate	set-control-template
setCopyCount	set-copy-count
setCopyright	set-copy-right
setCrosshairDistance	set-crosshair-distance
setCrosshairPaint	set-crosshair-paint
setCurrentKey	set-current-key
setCurrentNativeFocusedWindow	set-current-native-focused-window
setCurrentObj	set-current-obj
setCurrentStory	set-current-story
setCurrentTheme	set-current-theme
setCursorPosition	set-cursor-position
setCvsServer	set-cvs-server
setDConfigBeanVersionType	set-d-config-bean-version-type
setDTDContentModelSource	set-dtd-content-model-source
setDataDelegates	set-data-delegates
setDebugLevel	set-debug-level
setDefaultInlineStyle	set-default-inline-style
setDefaultParamsForApps	set-default-params-for-apps
setDefaultRID	set-default-rid
setDefaultRow	set-default-row
setDefaultScriptExtension	set-default-script-extension
setDefaultStream	set-default-stream
setDefiningTaskNodeText	set-defining-task-node-text
setDelays	set-delays
setDelete	set-delete
setDeliverEvents	set-deliver-events
setDesignConverter	set-design-converter
setDesiredHelpSystemId	set-desired-help-system-id
setDialogBoundsSettings	set-dialog-bounds-settings
setDistributedState	set-distributed-state
setDocTypePublic	set-doc-type-public
setDomainAxisMinValueExpression	set-domain-axis-min-value-expression
setEmpId	set-emp-id
setEmpty	set-empty
setEmptyFilterText	set-empty-filter-text
setEnabledNatures	set-enabled-natures
setEndJavaLine	set-end-java-line
setErrHandler	set-err-handler
setErrorCode	set-error-code
setEstimatedCost	set-estimated-cost
setEventCancelled	set-event-cancelled
setExcludeDefaultListeners	set-exclude-default-listeners
setExcludeDefaults	set-exclude-defaults
setExcludeSuperclassListeners	set-exclude-superclass-listeners
setExitPosition	set-exit-position
setExpectedAuthResponse	set-expected-auth-response
setExternalId	set-external-id
setExtraArguments	set-extra-arguments
setExtraChecking	set-extra-checking
setFallback	set-fallback
setFieldList	set-field-list
setFieldsNormalized	set-fields-normalized
setFilesProcessed	set-files-processed
setFilter	set-filter
setFixLastLine	set-fix-last-line
setFixedRateTasks	set-fixed-rate-tasks
setFocusedObject	set-focused-object
setFocusedThread	set-focused-thread
setFontSize	set-font-size
setFontSizeValues	set-font-size-values
setForAppleJDKs	set-for-apple-jdks
setForDummyApplet	set-for-dummy-applet
setForegroundToErrorColor	set-foreground-to-error-color
setFormSupport	set-form-support
setFormatFactoryClass	set-format-factory-class
setFromName	set-from-name
setGenerateBefore	set-generate-before
setGenerateFinderMethods	set-generate-finder-methods
setGopherPort	set-gopher-port
setHandlerClass	set-handler-class
setHasCPHelper	set-has-cp-helper
setHbmGen	set-hbm-gen
setHeaders	set-headers
setHelpPanel	set-help-panel
setHideDelay	set-hide-delay
setHierarchy	set-hierarchy
setHighlightPreferenceKey	set-highlight-preference-key
setHorizontalScrollPixel	set-horizontal-scroll-pixel
setHoverImageDescriptor	set-hover-image-descriptor
setHoverMode	set-hover-mode
setHspace	set-hspace
setImageIndent	set-image-indent
setInitializeFromJarPackage	set-initialize-from-jar-package
setInjarsref	set-in-jars-ref
setInputFromAction	set-input-from-action
setInstallDir	set-install-dir
setInstanceAttr	set-instance-attr
setIntervalWidth	set-interval-width
setInvokerURLPrefix	set-invoker-url-prefix
setIsBuiltin	set-is-builtin
setItems	set-items
setJDBCConnectionPoolProperty	set-jdbc-connection-pool-property
setKeyType	set-key-type
setKeyalg	set-keyalg
setLabelposition	set-label-position
setLanguageText	set-language-text
setLastAddedTime	set-last-added-time
setLastBuildDate	set-last-build-date
setLatestCompliance	set-latest-compliance
setLauncherProvider	set-launcher-provider
setLazyAttachmentOptimization	set-lazy-attachment-optimization
setLazyReferencesAllowed	set-lazy-references-allowed
setLeadSelection	set-lead-selection
setLeftAdjustment	set-left-adjustment
setLexHandler	set-lex-handler
setLimit	set-limit
setLine1	set-line-1
setLine2	set-line-2
setLines	set-lines
setLinks	set-links
setListRepositoryProperty	set-list-repository-property
setLoadOrder	set-load-order
setLocalFiles	set-local-files
setLocalizingBundle	set-localizing-bundle
setLockStatus	set-lock-status
setLockedSize	set-locked-size
setLoggingEnabled	set-logging-enabled
setManagedConnectionFactoryProperties	set-managed-connection-factory-properties
setMapKeyManyToManyColumns	set-map-key-many-to-many-columns
setMapResources	set-map-resources
setMappedProperty	set-mapped-property
setMappingLocation	set-mapping-location
setMatchHeadIfRevisionNotFound	set-match-head-if-revision-not-found
setMatchingContext	set-matching-context
setMaxDocCharsToAnalyze	set-max-doc-chars-to-analyze
setMaxRepetitions	set-max-repetitions
setMaxValueExpression	set-max-value-expression
setMemberFilters	set-member-filters
setMenuItemImage	set-menu-item-image
setMetaData	set-meta-data
setMinAdvance	set-min-advance
setModeFrameState	set-mode-frame-state
setModelProviderIds	set-model-provider-ids
setModifiedFiles	set-modified-files
setModuleCounter	set-module-counter
setMonthlyAbsoluteFrequency	set-monthly-absolute-frequency
setMouseMoveAdjusts	set-mouse-move-adjusts
setMultiThreaded	set-multi-threaded
setNameParser	set-name-parser
setNativeConnectionNecessaryForNativePreparedStatements	set-native-connection-necessary-for-native-prepared-statements
setNativeCursor	set-native-cursor
setNativeFocusedWindow	set-native-focused-window
setNodeDelegate	set-node-delegate
setNodeIcon	set-node-icon
setNodeusesparser	set-node-uses-parser
setNonChangeCheck	set-non-change-check
setNonFilteredLiteFeatures	set-non-filtered-lite-features
setNotebookNcName	set-notebook-nc-name
setNullFormatter	set-null-formatter
setOSTypes	set-os-types
setObjectFive	set-object-five
setObjectLocalName	set-object-local-name
setObjectNodeType	set-object-node-type
setOnlytojava	set-only-to-java
setOutConvertorFactory	set-out-convertor-factory
setOverlayText	set-overlay-text
setPageAttribute	set-page-attribute
setPaperUndo	set-paper-undo
setParent	set-parent
setParentOriginProvider	set-parent-origin-provider
setParentType	set-parent-type
setPauseAfter	set-pause-after
setPduType	set-pdu-type
setPixelsToAddToSelection	set-pixels-to-add-to-selection
setPlatformAdmin	set-platform-admin
setPluginFilePath	set-plugin-file-path
setPortNumber	set-port-number
setPositionalParameterTypes	set-positional-parameter-types
setPrepareConnection	set-prepare-connection
setPreviewEnabled	set-preview-enabled
setPreviousFlushMode	set-previous-flush-mode
setPrinterData	set-printer-data
setPrivateKey	set-private-key
setPrivateMod	set-private-mod
setPrivateProperty	set-private-property
setProfiledProject	set-profiled-project
setProgrammatic	set-programmatic
setProtectConstructor	set-protect-constructor
setProxy2cjcrePort	set-proxy-2-cjc-report
setProxyClassType	set-proxy-class-type
setQNameAttribute	set-q-name-attribute
setQWForFiles	set-qw-for-files
setRGBAt	set-rgb-at
setRangeDescription	set-range-description
setRangeMinorGridlineStroke	set-range-minor-gridline-stroke
setRank	set-rank
setRate	set-rate
setRdocTypeInference	set-rdoc-type-inference
setReadTimeouts	set-read-timeouts
setReceiverRange	set-receiver-range
setRecentlyChangedFilters	set-recently-changed-filters
setReferencedColumns	set-referenced-columns
setReferencedIdProperty	set-referenced-id-property
setRefreshFieldScope	set-refresh-field-scope
setRejectedSessionCount	set-rejected-session-count
setRelValue	set-rel-value
setRelationName	set-relation-name
setRelationships	set-relation-ships
setRemoteFile	set-remote-file
setRemoteUIHost	set-remote-ui-host
setRenderers	set-renderers
setRendering	set-rendering
setReplicateEventListeners	set-replicate-event-listeners
setRequestSentTime	set-request-sent-time
setRequestedSessionCookie	set-requested-session-cookie
setRequests	set-requests
setRestoring	set-restoring
setRestrictedClasses	set-restricted-classes
setResultException	set-result-exception
setRollofFactor	set-roll-of-factor
setRootBeanClass	set-root-bean-class
setRowForeground	set-row-foreground
setSAAJ	set-saaj
setSaveSnapshot	set-save-snapshot
setScanResources	set-scan-resources
setScannerListeners	set-scanner-listeners
setScheduleForAssignments	set-schedule-for-assignments
setScriptCharset	set-script-charset
setSelectedNode	set-selecte-dnode
setSensitivity	set-sensitivity
setSeriesColorSequence	set-series-color-sequence
setSeriesNegativeItemLabelPosition	set-series-negative-item-label-position
setServiceHAName	set-service-ha-name
setServicePort	set-service-port
setServletMappings25	set-servlet-mappings-25
setSessionAttributeCol	set-session-attribute-col
setSessionDomain	set-session-domain
setSessionThread	set-session-thread
setSessionType	set-session-type
setShape	set-shape
setSheet	set-sheet
setSheetProperty	set-sheet-property
setShell	set-shell
setShowAgainBrokenRefAlert	set-show-again-broken-ref-alert
setShowDebug	set-show-debug
setShowProgressIndicator	set-show-progress-indicator
setSkills	set-skills
setSortString	set-sort-string
setSort_type	set-sort-type
setSourceObjects	set-source-objects
setSourceSchemaName	set-source-schema-name
setSourcerootsref	set-source-roots-ref
setSpecificJREDescriptor	set-specific-jre-descriptor
setSplashInfo	set-splash-info
setSpread	set-spread
setSprint	set-sprint
setStackMap	set-stack-map
setStackVisible	set-stack-visible
setStandardRate	set-standard-rate
setStarterDirectoryForLoadBugs	set-starter-directory-for-load-bugs
setStatusAdapter	set-status-adapter
setStoreProtClass	set-store-prot-class
setStreamsForBinaryEnabled	set-streams-for-binary-enabled
setSunJDK14IsLocalBugFix	set-sun-jdk14-is-local-bug-fix
setSuperclassType	set-superclass-type
setSuperscript	set-superscript
setSupportsCatalogsInProcedureCalls	set-supports-catalogs-in-procedure-calls
setSuppressVariableNotUsed	set-suppress-variable-not-used
setTemplateParameters	set-template-parameters
setTemporaryWatch	set-temporary-watch
setTestAttribute	set-test-attribute
setTestJavaFlags	set-test-java-flags
setTestPageSource	set-test-page-source
setTextAlignment	set-text-alignment
setTextShadow	set-text-shadow
setTiVoEnabled	set-tivo-enabled
setTimeOut	set-timeout
setTitleInternal	set-title-internal
setTldJars	set-tld-jars
setTomcatInstall	set-tomcat-install
setTooltipCssClass	set-tooltip-css-class
setTotalTests	set-total-tests
setTraceDirectory	set-trace-directory
setTransactionXA	set-transaction-xa
setTransactional	set-transactional
setTransportProtocolClass	set-transport-protocol-class
setTreeColumnIndex	set-treecolumn-index
setTreeSelectedTopic	set-tree-selected-topic
setTrustStore	set-trust-store
setTypeClass	set-type-class
setTypeExp	set-type-exp
setUUIDRefs	set-uuid-refs
setUpEdgePopup	set-up-edge-popup
setUpdateLabels	set-update-labels
setUseChildrenVariables	set-use-children-variables
setUseHashlookup	set-use-hash-lookup
setUsePluginRegistry	set-use-plugin-registry
setUseWinIcoFile	set-use-win-ico-file
setUserDefinedJavaLogicalStructures	set-user-defined-java-logical-structures
setUserInludePaths	set-user-inlude-paths
setUserTypeIdInfo	set-user-type-id-info
setUsesManifest	set-uses-manifest
setUtf8Value	set-utf8-value
setValuesFont	set-values-font
setValuesFrom	set-values-from
setVariableCallSite	set-variable-call-site
setVectorSpace	set-vector-space
setVisibleEditor	set-visible-editor
setVssServerPath	set-vss-server-path
setWarningLevel	set-warning-level
setWorkPhone	set-work-phone
setWorkerType	set-worker-type
setWrapGuidePainted	set-wrap-guide-painted
setWsdlPortId	set-wsdl-port-id
setXAxisVerticalTickLabels	set-x-axis-vertical-tick-labels
setXHTMLNamespace	set-xhtml-namespace
setXMLStreamWriter	set-xml-stream-writer
setXmlSqlHistoryList	set-xml-sql-history-list
setXmlStandalone	set-xml-standalone
setrlimit	set-r-limit
setupAndShowDialog	setup-and-show-dialog
setupAutoAuth	setup-auto-auth
setupLocationControls	setup-location-controls
setupProtocolHandlers	setup-protocol-handlers
setupSQLSessionContextForChildren	setup-sql-session-context-for-children
shouldAddToLogicalLeftOfTable	should-add-to-logical-left-of-table
shouldLaunchLast	should-launch-last
shouldOverwriteCurrentVersion	should-overwrite-current-version
shouldProtectConstructor	should-protect-constructor
shouldShowCellTipAt	should-show-cell-tip-at
shouldStop	should-stop
showAcceptCancelDialog	show-accept-cancel-dialog
showBuildActionWarning	show-build-action-warning
showButton	show-button
showConnectToServerDialog	show-connect-to-server-dialog
showCreateRenderingTab	show-create-rendering-tab
showCurrentFrame	show-current-frame
showErrorIncludeDialog	show-error-include-dialog
showFilter	show-filter
showHeapParametersPanel	show-heap-parameters-panel
showJavaClass	show-java-class
showProviderNotification	show-provider-notification
showWaitCursor	show-wait-cursor
showYesNoDialog	show-yes-no-dialog
showexception	show-exception
signaturesEqual	signatures-equal
simpleBinaryNameTerm	simple-binary-name-term
simpleNameSelected	simple-name-selected
singleByteUpcase	single-byte-upcase
sizeMessageDestination	size-message-destination
skipAttributeValue	skip-attribute-value
skipName	skip-name
skipNestedParens	skip-nested-parens
skipResource	skip-resource
sortAttributes	sort-attributes
sortBundleInfos	sort-bundle-infos
sortColumn	sort-column
sortInts	sort-ints
sortPostings	sort-postings
sortTabDescriptorsByAfterTab	sort-tab-descriptors-by-after-tab
sourceInfo	source-info
sourceMethod	source-method
sourceReader	source-reader
sp	sp
spawnChildFromEnterAttribute	spawn-child-from-enter-attribute
spawnValidityChecker	spawn-validity-checker
splitArrayElementsIntoProperties	split-array-elements-into-properties
standardDeleteFolder	standard-delete-folder
startAdditionalThreads	start-additional-threads
startBlockCall	start-block-call
startDebug	start-debug
startExternalSubset	start-external-subset
startFillPath	start-fill-path
startForking	start-forking
startLocalConnectorServer	start-local-connector-server
startLogReceiverThread	start-log-receiver-thread
startPage	start-page
startPass	start-pass
startPlaying	start-playing
startWithProperty	start-with-property
startingTestSuite	starting-test-suite
startupMapHook	startup-map-hook
state_push	state-push
stmtNeedsChange	stmt-needs-change
stopBeans	stop-beans
stopRunning	stop-running
stopTestRun	stop-test-run
storeDependencyInfo	store-dependency-info
storeEtchedBorder	store-etched-border
storeInLocalRepository	store-in-local-repository
storeQueryIssues	store-query-issues
strRindex	str-r-index
stringToLong	string-to-long
structSectionForClass	struct-section-for-class
struct_time___eq__	struct-time-eq
subInspect	sub-inspect
subOrSuperOfFocus	sub-or-super-of-focus
subroutine	subroutine
substNewLines	subst-new-lines
subtractRanges	subtract-ranges
superNotifyModified	super-notify-modified
super_p	super-p
supportsBelowTheSpot	supports-below-the-spot
supportsExpressionsInOrderBy	supports-expressions-in-order-by
supportsMulticast0	support-smulticast-0
supportsQueryParameterType	supports-query-parameter-type
supportsSchemasInTableDefinitions	supports-schemas-in-table-definitions
supportsStepFilters	supports-step-filters
sv	sv
swallowedException	swallowed-exception
switchFilterBySummaryHighlight	switch-filter-by-summary-highlight
switchLogFile	switch-log-file
syncSpi	sync-spi
syncStateChanged	sync-state-changed
syntheticEnclosingInstances	synthetic-enclosing-instances
systemStarted	system-started
system_propertyF	system-property-f
t	t
tabSelectionChanged	tab-selection-changed
tableStructureChanged	table-structure-changed
takeIPv4Address	take-ipv4-address
tcUnionBadDisc	tc-union-bad-disc
td	td
tdProcess	td-process
templateTypeParameter	template-type-parameter
term1Rest	term1-rest
terminateProgress	terminate-progress
testAllRegressionFiles	test-all-regression-files
testArrayFirstCommonSuperclassTricky	test-array-first-common-superclass-tricky
testBasicInsertion	test-basic-insertion
testBasicTask	test-basic-task
testClone	test-clone
testClose	test-close
testCloseOnDuplicateStatement	test-close-on-duplicate-statement
testCreationBasicWithNulls	test-creation-basic-with-nulls
testExternalAddressChange	tes-texternal-address-change
testFilters	test-filters
testHasClient	test-has-client
testHashToString	test-hash-to-string
testInitializerJavadocParsing1	test-initializer-javadoc-parsing-1
testIsEmpty	test-is-empty
testLicenses	test-licenses
testMpp14Baseline	test-mpp14-base-line
testMpp14EnterpriseFields	test-mpp14-enterprise-fields
testScanStringLiteral	test-scan-string-literal
testStringSubtypeOfSerializable	test-string-subtype-of-serializable
test_lexSingleLine	test-lex-single-line
tf	tf
tfAddressActionPerformed	tf-address-action-performed
th	th
thisOrNothing	this-or-nothing
threeDotsWithMajor	three-dots-with-major
throwGenericSQLException	throw-generic-sql-exception
throwIllegalCharacterDataException	throw-illegal-character-data-exception
throwParseErrorsException	throw-parse-errors-exception
throwParseTimeException	throw-parse-time-exception
throwsNoException	throws-no-exception
throwsTagOutput	throws-tag-output
thumbnailPassComplete	thumbnail-pass-complete
tilde	tilde
timer	timer
timerCancel	timer-cancel
timerTick	timer-tick
times	times
to	to
toBack_NoClientCode	to-back-no-client-code
toBundleInfo	to-bundle-info
toData	to-data
toDate	to-date
toDays	to-days
toEscapedUnicode	to-escaped-unicode
toLibraryLocation	to-library-location
toStringBrief	to-string-brief
toTarget	to-target
toUniqueID	to-unique-id
toggleLogging	toggle-logging
tokenizeToStringArray	tokenize-to-string-array
tooHigh	too-high
torrentAdded	torrent-added
touchFile	touch-file
tr	tr
traceAddedContributors	trace-added-contributors
traceInto	trace-into
traceObjAlloc	trace-obj-alloc
trackOutsideTrimArea	track-outside-trim-area
trackPosition	track-position
transFormKeyKode	transform-key-kode
transactionalProperties	transactional-properties
transformInvokevirtualsIntoPutfields	transform-invoke-virtuals-into-put-fields
transformMapWithXslt	transform-map-with-xslt
translateIndex	translate-index
translateKeyEvent	translate-key-event
translateToValue	translate-to-value
trashInternal	trash-internal
triggerEditorActivationEvent	trigger-editor-activation-event
triggerLanguageChange	trigger-language-change
trim2ParentResources	trim-2-parent-resources
trimForDisplay	trim-for-display
trimMenu	trim-menu
trimWhiteSpacesAndComments	trim-whitespaces-and-comments
tryFile	try-file
tryIssueTakeback	try-issue-take-back
tryReadLock	try-read-lock
tryRefreshProviders	try-refresh-providers
trySimplifyNe	try-simplify-ne
turnModules	turn-modules
txtAdminActionPerformed	txt-admin-action-performed
typeArgument	type-argument
typeChar	type-char
typeCheckBody	type-check-body
typesToHandles	types-to-handles
u	u
u1	u-1
u2	u-2
u4	u-4
uc	uc
uint16Value	uint16-value
ul	ul
unHyperlink	un-hyperlink
undeployInternal	undeploy-internal
undoComponentPropertyChange	undo-component-property-change
undoComponentRegistration	undo-component-registration
undoDoAction	undo-do-action
unexpandLine	un-expand-line
ungetService	un-get-service
unicode___cmp__	unicode-cmp
unicode_index	unicode-index
unifyPath	unify-path
uninstallKeyListener	uninstall-key-listener
uniqueIntId	unique-int-id
unknownCorbaExc	unknown-corba-exc
unlockItem	unlock-item
unlockKeystore	unlock-key-store
unmarshalStaxSource	unmarshal-stax-source
unmodifiableSortedSet	unmodifiable-sorted-set
unmount	unmount
unpackFile	unpack-file
unquote	unquote
unregisterAdditionalFileType	unregister-additional-file-type
unregisterAutoEditVetoer	unregister-auto-edit-vetoer
unregisterDnd	unregister-dnd
unregisterManagedResource	unregister-managed-resource
unsetProgressComponent	unset-progress-component
unwrapPassedBlock	unwrap-passed-block
up	up
update	update
updateCache	update-cache
updateCacheIfNecessary	update-cache-if-necessary
updateCategory	update-category
updateCodeView	update-code-view
updateDefaultTypeComponent	update-default-type-component
updateDesktop	update-desktop
updateDropTarget	update-drop-target
updateEditorDisplayNames	update-editor-display-names
updateEditorInput	update-editor-input
updateFocusTraversalKeys	update-focus-traversal-keys
updateHorizontalLayoutState	update-horizontal-layout-state
updateImpButtons	update-imp-buttons
updateImplicitReceivers	update-implicit-receivers
updateInputEditor	update-input-editor
updateInspector	update-inspector
updateJars	update-jars
updateLengthyAtomicEdit	update-lengthy-atomic-edit
updateLocations	update-locations
updateMethodPermission	update-method-permission
updateMetrics	update-metrics
updateNumberUI	update-number-ui
updateOffsetsFromARGB	update-offsets-from-argb
updateOverride	update-override
updateProjectMetadata	update-project-metadata
updatePublicIdComponent	update-public-id-component
updateRectangleToFitToView	update-rectangle-to-fit-toview
updateRegModified	update-reg-modified
updateRememberedTags	update-remembered-tags
updateReservations	update-reservations
updateSelectedResource	update-selected-resource
updateSeparatorVisibility	update-separator-visibility
updateSequenceFrames	update-sequence-frames
updateSetterMethod	update-setter-method
updateSidebarVisibility	update-sidebar-visibility
updateSizeIfNecessary	update-size-if-necessary
updateStructureOfIthParamFrom	update-structure-of-ith-param-from
updateTargetValue	update-target-value
updateTiledLayerDCProps	update-tiled-layer-dc-props
updateToNextWorkStart	update-to-next-work-start
updateUIWhenHidden	update-ui-when-hidden
updateVariable	update-variable
updateVisualSettings	update-visual-settings
updateWindowAccel	update-window-accel
updateZoom	update-zoom
upgradeSchema	upgrade-schema
urgencyToString	urgency-to-string
urlIsBlocked	url-is-blocked
useAsGlobalRuntime	use-as-global-runtime
useColorNameLookup	use-color-name-lookup
useCustomReloadChildren	use-custom-reload-children
useMaxForLimit	use-max-for-limit
useModuleAndProjectName	use-module-and-project-name
useMultiplexer	use-multiplexer
useTag	use-tag
usefulStopKey	useful-stop-key
userDataConstraintCBActionPerformed	user-data-constraint-cb-action-performed
usesFixedEnglishStrings	uses-fixed-english-strings
usesSqlAuthorization	uses-sql-authorization
validJavaIdentifier	valid-java-identifier
validateBean	validate-bean
validateBind	validate-bind
validateCreateLink	validate-create-link
validateFeatureAttributes	validate-feature-attributes
validateFormValidator	validate-form-validator
validateMethodInvocation	validate-method-invocation
validateOverloadedOperations	validate-overloaded-operations
validatePercent	validate-percent
validateProjectLocationURI	validate-project-location-uri
valuesEqual	values-equal
variableClashes	variable-clashes
variablePreferencesPut	variable-preferences-put
variant	variant
verboseMessage	verbose-message
verbose_container_initialization_failed	verbose-container-initialization-failed
verbose_failed_to_instanciate_container_initializer	verbose-failed-to-instanciate-container-initializer
verifyAndFire	verify-and-fire
verifyBorlandJarV4	verify-borland-jar-v4
verifyBorlandJarV5	verify-borland-jar-v5
verifyClass	verify-class
verifyIV	verify-iv
verifyIndex	verify-index
verifyOrientation	verif-y-orientation
verifySQLLimit	verify-sql-limit
verifySessionRemote	verify-session-remote
version9to10	version-9to10
visitBASTORE	visit-bastore
visitBinaryExpression	visit-binary-expression
visitBreakStatement	visit-break-statement
visitChoice	visit-choice
visitDeclarationExpression	visit-declaration-expression
visitEnclosingMethod	visit-enclosing-method
visitForStatement	visit-for-statement
visitSlAssign	visit-sl-assign
visitSourceFile	visit-source-file
visitThrowNode	visit-throw-node
visitingMethod	visiting-method
vm	vm
w	w
waitEntryCPU	wait-entry-cpu
waitForEarlyStartup	wait-for-early-startup
waitUntilIdle	wait-until-idle
warehouse	warehouse
wasRun	was-run
webkit_web_policy_decision_download	webkit-web-policy-decision-download
weekendStart	weekend-start
whichDoctypePublic	which-doc-type-public
whiteSpace	white-space
whitelistRegexes	whitelist-regexes
wi	wi
windowClosed	window-closed
withAllEntityReferencesDo	with-all-entity-references-do
withAllQNamesDo	with-all-q-names-do
wizardEnabled	wizard-enabled
wordSpacingUnitComboItemStateChanged	word-spacing-unit-combo-item-state-changed
wrapCallableStatement	wrap-callable-statement
wrapMBeanServer	wrap-m-bean-server
wrapStringOnPanel	wrap-string-on-panel
writeArchiveMagic	write-archive-magic
writeArchiverConfiguration	write-archiver-configuration
writeAttributeWithPrefix	write-attribute-with-prefix
writeBodyAsXML	write-body-as-xml
writeChecksumSignature	write-check-sum-signature
writeDelegateInitialization	write-delegate-initialization
writeElementDataset	write-element-dataset
writeEndParagraph	write-end-paragraph
writeFourStateAttributes	write-four-state-attributes
writeGetSafeBaseIds	write-get-safe-base-ids
writeHandler	write-handler
writeInPlaceLocation	write-in-place-location
writeLittleEndian	write-little-endian
writeLocalRollback_	write-local-rollback
writeLongFdocaData	write-long-f-doca-data
writeLongString	write-long-string
writeOctets	write-octets
writeOutxmlFile	write-out-xml-file
writeParentXML	write-parent-xml
writeQRYNOPRM	write-qrynoprm
writeScalarPaddedString	write-scalar-padded-string
writeSceneItemsToSceneDC	write-scene-items-to-scene-dc
writeSingletonTag	write-singleton-tag
writeSolaris	write-solaris
writeStringToStringsArrMap	write-string-to-strings-arr-map
writeStubConstructors	write-stub-constructors
writeToDisk	write-to-disk
writeToSAX	write-to-sax
writeToTLD	write-to-tld
writeToXML	write-to-xml
writeToXml	write-to-xml
writeWithReferenceType	write-with-reference-type
writeXaCommit	write-xa-commit
write_Principal	write-principal
writeover	writeover
ws	ws
x	x
xmlLangToLocale	xml-lang-to-locale
xscan	xscan
xy	xy
y	y
yychar	yychar
z	z
