$method_newClient_1	method-new-client-1
$pyObjArr	py-obj-arr
A	a
A0	a-0
A1	a-1
A2	a-2
A3	a-3
A4	a-4
A5	a-5
A6	a-6
A7	a-7
A8	a-8
A9	a-9
ABBREV_MAP	abbrev-map
ABORT_NOTHING_TO_RUN	abort-nothing-to-run
ABOUT_MAPPINGS	about-mappings
AC	ac
ACCEPT_NONE	accept-none
ACCESSIBLE_TABLE_SUMMARY_CHANGED	accessible-table-summary-changed
ACCESS_HEAP_V2_ID	access-heap-v2-id
ACCESS_U8_V1_ID	access-u8-v1-id
ACS_DISPLAY_NAME_VALUE	acs-display-name-value
ACTION_COMMAND_DESELECTED	action-command-deselected
ACTION_COMPLETION_END	action-completion-end
ACTION_ESCAPE_TABLE	action_escape-table
ACTION_PUBLISH	action-publish
ACTION_SELECT_INVERT	action-select-invert
ACTIVERECORD	active-record
ACTIVE_WORKBENCH_WINDOW_IS_COOLBAR_VISIBLE_NAME	active-workbench-window-is-coolbar-visible-name
ACTIVITY_IMAGE_BINDING_DESC	activity-image-binding-desc
ACT_CHECK_SEEDING_SHORT_DELAY	act-check-seeding-short-delay
AD	ad
ADD_JAVA_DOC_COMMENT	add-java-doc-comment
ADD_TO_CLASSPATH_ACTION	add-to-classpath-action
ADVISED_BY	advised-by
AE	ae
AGENT_STATE_NOT_RUNNING	agent-state-not-running
AH	ah
AJAXIFY_JSF_CRUD	ajaxify-jsf-crud
AL	al
ALIGN_RIGHT	align-right
ALLOC_CAPTION	alloc-caption
ALLOW_ENUMS_KEY	allow-enums-key
ALPHA_MASK_PACKED	alpha-mask-packed
ALPHA_MASK_RGB	alpha-mask-rgb
ALTERED_SIDE_EFFECT_REMOVE	altered-side-effect-remove
AL_MSG_BT_HAND	al-msg-bt-hand
AL_MSG_BT_HAVE	al-msg-bt-have
AL_MSG_BT_REJECT_REQUEST	al-msg-bt-reject-request
AM	am
AMBIGOUS_HINT	ambigous-hint
AND_NODE	and-node
ANN_RUN_WITH	ann-run-with
ANTEDITOR_FILTER_INTERNAL_TARGETS	anteditor-filter-internal-targets
ANT_HEADLINE	ant-headline
ANT_VERBOSE_STREAM	ant-verbose-stream
APPCLIENT_ARGS	appclient-args
APPLICATION_JAR_NAME	application-jar-name
APP_PREFIX	app-prefix
APR_ANYADDR	apr-anyaddr
APR_FINFO_MTIME	apr-finfo-mtime
APR_RESET_NODELAY	apr-reset-nodelay
AR	ar
ARCHETYPE_CATALOG_1_0_0	archetype-catalog-1-0-0
ARCHIVE_EXTENSIONS	archive-extensions
ARCH_88k	arch-88k
ARGUMENT_PASSWORD_SHORTFORM	argument-password-shortform
ARG_PREFIX	arg-prefix
ARRAY_END	array-end
ARRAY_GAP	array-gap
ASPECTJ_ANNOTATION_PARAMETER_NAME_DISCOVERER	aspectj-annotation-parameter-name-discoverer
ASPECT_CU	aspect-cu
ASPECT_INSTANCE_FACTORY_INDEX	aspect-instance-factory-index
ASSOCIATION_ASK_USER	association-ask-user
ASYNC_LOADER_CLASS_PREFIX	async-loader-class-prefix
AS_LAST_TAB	as-last-tab
AT	at
ATK_STATE_MULTI_LINE	atk-state-multi-line
ATTIDX_MINOCCURS	attidx-minoccurs
ATTRIBUTE_bottomPadding	attribute-bottom-padding
ATTRIBUTE_fontSize	attribute-font-size
ATTRIBUTE_isDefault	attribute-is-default
ATTR_APPLICATION_MODEL	attr-application-model
ATTR_BORDER_TOP	attr-border-top
ATTR_CARDINALITY	attr-cardinality
ATTR_FINAL	attr-final
ATTR_HEADERS	attr-headers
ATTR_NAME_CHANGED	attr-name-changed
ATTR_NAME_ELEMENT_TYPE	attr-name-element-type
ATTR_PITCH_RANGE	attr-pitch-range
ATTR_SUMMARY	attr-summary
ATT_CONFIG_INTRO_ID	att-config-intro-id
ATT_PLATFORM	att-platform
ATT_UNIVERSE_FIELD	att-universe-field
AU	au
AUTHORITATIVE	authoritative
AUTH_NO_LDAP_HOST_MENTIONED	auth-no-ldap-host-mentioned
AUTOSPEC_LOADER	autospec-loader
AUTOWIRE_AUTODETECT	autowire-autodetect
AVAILABLE_SPECIFIED	available-specified
AX	ax
AXIS_PARENT	axis-parent
AboutFeaturesDialog_provider	about-features-dialog-provider
AbstractAnnotationHover_action_configureAnnotationPreferences	abstract-annotation-hover-action-configure-annotation-preferences
AddDelegateMethodsAction_description	add-delegate-methods-action-description
AddFeatureContainersPage_0	add-feature-containers-page-0
AddFeatureContainersPage_1	add-feature-containers-page-1
AddFeatureContainersPage_2	add-feature-containers-page-2
Ah	ah
Al	al
AnnotationDeprecated	annotation-deprecated
AntHomeClasspathEntry_8	ant-home-classpath-entry-8
AntHomeClasspathEntry_9	ant-home-classpath-entry-9
AntNewJavaProjectPage_0	ant-new-java-project-page-0
AntNewJavaProjectPage_1	ant-new-java-project-page-1
AntNewJavaProjectPage_2	ant-new-java-project-page-2
AntNewJavaProjectPage_3	ant-new-java-project-page-3
AntNewJavaProjectPage_9	ant-new-java-project-page-9
AntTargetsTab_12	ant-targets-tab-12
AntTargetsTab_13	ant-targets-tab-13
AntTargetsTab_14	ant-targets-tab-14
AntTargetsTab_15	ant-targets-tab-15
AntTargetsTab_16	ant-targets-tab-16
AntTargetsTab_17	ant-targets-tab-17
Ar	ar
ArgumentTypeCannotBeVoid	argument-type-cannot-be-void
ArrayLength	array-length
ArrayTypeImpl_getValues_not_allowed_on_array_1	array-type-impl-get-values-not-allowed-on-array-1
As	as
AutomaticUpdatesPopup_UpdatesAvailableTitle	automatic-updates-popup-updates-available-title
Ax	ax
Ay	ay
Az	az
B	b
B0	b-0
B1	b-1
B2	b-2
B3	b-3
B4	b-4
B5	b-5
B6	b-6
B7	b-7
B8	b-8
B9	b-9
BACKGROUNDCOLOR	background-color
BASELINE_LEADING	baseline-leading
BC	bc
BD	bd
BEFORE_START_EVENT	before-start-event
BG	bg
BH	bh
BIG_SIZE	big-size
BL	bl
BLACK_PROMOTION_TARGETS	black-promotion-targets
BLUEJ_VERSION_TITLE	bluej-version-title
BP	bp
BR	br
BROWSER_FIELDS	browser-fields
BROWSER_TEMPLATE	browser-template
BROWSE_BUTTON_ACCESS_DESCR	browse-button-access-descr
BS	bs
BUILDFILE_PROBLEM_MARKER	buildfile-problem-marker
BUILDING_FIELDS_AND_METHODS	building-fields-and-methods
BW	bw
BX	bx
BYTE_CHARSET	byte-charset
B_GE_removed	b-ge-removed
Background	background
Bl	bl
BlankLinesTabPage_compilation_unit_option_before_package	blank-lines-tab-page-compilation-unit-option-before-package
BreakpointHitCountAction_Enable_Hit_Count_1	breakpoint-hit-count-action-enable-hit-count-1
BrowserCount	browser-count
BuildErrorReporter_srcIncludesSourceFolder1	build-error-reporter-src-includes-source-folder-1
BuildPathDialogAccess_ExistingClassFolderDialog_new_description	build-path-dialog-access-existing-class-folder-dialog-new-description
Builders_Schema_referencedElementNotFound	builders-schema-referenced-element-not-found
C	c
C0	c-0
C1	c-1
C2	c-2
C3	c-3
C4	c-4
C5	c-5
C6	c-6
C7	c-7
C8	c-8
C9	c-9
CACHE_TOKENS	cache-tokens
CAIRO_FONT_WEIGHT_BOLD	cairo-font-weight-bold
CAIRO_LINE_JOIN_MITER	cairo-line-join-miter
CARET_COLOR_INSERT_MODE	caret-color-insert-mode
CAT_TIME	cat-time
CC	cc
CDATA_EMBEDED_END	cdata-embeded-end
CE	ce
CERT_KEY	cert-key
CFG_TEMPLATES_PATH	cfg-templates-path
CFG_VALIDATORS	cfg-validators
CH	ch
CHARSET_RIF	charset-rif
CHARS_PUBLIC	chars-public
CHAR_VALUE	char-value
CHARcode	char-code
CHEATSHEET_OBJ	cheatsheet-obj
CHEATSHEET_VIEW	cheatsheet-view
CHECKOUT_MODULE_SELECTION_PAGE	checkout-module-selection-page
CHECK_ANNOTATION	check-annotation
CHECK_INTERVAL	check-interval
CHILD_OFS_SIZE_3	child-ofs-size-3
CHILD_OFS_SIZE_4	child-ofs-size-4
CHM_LOAD_FACTOR	chm-load-factor
CJ	cj
CKA_PUBLIC_EXPONENT	cka-public-exponent
CKA_VALUE	cka-value
CKF_ENCRYPT	ckf-encrypt
CKF_SECONDARY_AUTHENTICATION	ckf-secondary-authentication
CKM_CAST5_MAC	ckm-cast5-mac
CKM_IDEA_CBC	ckm-idea-cbc
CKM_IDEA_ECB	ckm-idea-ecb
CKM_RIPEMD128_RSA_PKCS	ckm-ripemd128-rsa-pkcs
CKM_SHA512_HMAC	ckm-sha512-hmac
CK_INVALID_HANDLE	ck-invalid-handle
CL	cl
CLASS_FIELDS	class-fields
CLASS_HESIOD	class-hesiod
CLASS_MACRO	class-macro
CLASS_PATH_ATTR	class-path-attr
CLASS_PATH_RUNTIME_PATH	class-path-runtime-path
CMP_REMOTEHOME	cmp-remotehome
CN	cn
COALESCE_FUNCTION_NODE_NAME	coalesce-function-node-name
CODEELEMENT	code-element
CODEPOINTMASK	codepoint-mask
COLGROUP	col-group
COLLECTION_FACTORY	collection-factory
COLOR_WRITTEN	color-written
COLUMN_USAGE	column-usage
COL_ATTR	col-attr
COL_GRADIENT1	col-gradient-1
COL_GRADIENT2	col-gradient-2
COL_GRADIENT3	col-gradient-3
COL_OVER_GRADIENT1	col-over-gradient-1
COL_OVER_GRADIENT2	col-over-gradient-2
COL_OVER_GRADIENT3	col-over-gradient-3
COMBINED_HEADER	combined-header
COMBININGS_VALUES	combinings-values
COMET_FLAG	comet-flag
COMMAND_ENDIF	command-endif
COMMAND_GET_PROJECT	command-get-project
COMMENT_NEWLINE	comment-newline
COMMENT_TEMPLATE_PREFERENCE_PAGE	comment-template-preference-page
COMMIT_ITEM	commit-item
COMPATIBLE_VALUE	compatible-value
COMPLETE_IMAGE_PATH	complete-image-path
COMPLETE_WORK	complete-work
COMPONENTS_TO_INSTALL_TEXT_PROPERTY	components-to-install-text-property
COMPONENT_LAYOUT_CHANGED	component-layout-changed
COMPOSITOR_CHOICE	compositor-choice
CONDITION_CB012	condition-cb012
CONDITION_CB013	condition-cb013
CONDITION_CB023	condition-cb023
CONDITION_CB123	condition-cb123
CONFIGURATION_TYPES	configuration-types
CONFIG_DISCARD_MILLIS	config-discard-millis
CONFIG_FILE_ARCHIVE	config-file-archive
CONFIG_FILE_OPTION	config-file-option
CONFIG_TEMPLATE_LOCATION	config-template-location
CONFIRM_CLIENT_CERT_MODE	confirm-client-cert-mode
CONFLICTING_COLOR	conflicting-color
CONNECTIONDEFINITIONNAME	connection-definition-name
CONN_NO_DETAILS	conn-no-details
CONSTRUCTION_ERROR	construction-error
CONST_ADD_PROPERTY	const-add-property
CONST_ASSIGN	const-assign
CONTAINER_PAGE_NAME	container-page-name
CONTENT_AREA_FILLED_CHANGED_PROPERTY	content-area-filled-changed-property
CONTENT_MODEL_CHILDREN	content-model-children
CONTENT_POLICY_ADD_ALL	content-policy-add-all
CONTEXT_MEMBER	context-member
CONTRIBUTED	contributed
CONTRIBUTOR	contributor
CONVERGE_FACTOR	converge-factor
CORE_PARAM_INT_MAX_CONNECTIONS_PER_TORRENT	core-param-int-max-connections-per-torrent
COULD_NOT_SKIP_BYTES	could-not-skip-bytes
COUNTERCW	counter-cw
COUNTER_NAME	counter-name
CP	cp
CPPINCLUDE	cpp-include
CPU_PART_APP	cpu-part-app
CQ	cq
CR	cr
CREATE_MBEAN_LOADER	create-mbean-loader
CREATE_NEW	create-new
CRT_VALID_FLAGS	crt-valid-flags
CS	cs
CSS_DEG	css-deg
CSS_EMS	css-ems
CSS_EXS	css-exs
CSS_EXT	css-ext
CT_BLOCK	ct-block
CU	cu
CURRENT_BUFFER	current-buffer
CURRENT_TOOLTIP	current-tooltip
CURSOR_NEXT	cursor-next
CURSOR_OPERATION_CONFLICT	cursor-operation-conflict
CURVE_TAIL	curve-tail
CUSTOM_UNINSTALL	custom-uninstall
CVSAction_errorTitle	cvs-action-error-title
CVSCommunicationException_alternateInterruptSolution	cvs-communication-exception-alternate-interrupt-solution
CW	cw
CWBackPixmap	cw-back-pixmap
CX	cx
CYCLE_PERSPECTIVE_FORWARD_ACTION	cycle-perspective-forward-action
CallHierarchyViewPart_callsToMembers_2	call-hierarchy-view-part-calls-to-members-2
CallHierarchyViewPart_callsToMembers_3	call-hierarchy-view-part-calls-to-members-3
Cast_ClassCastException__Cannot_cast__0__as__1___1	cast-classcastexception-cannot-cast-0-as-1-1
CategoryFilterActionGroup_SelectAllCategories	category-filter-action-group-select-all-categories
CategorySection_remove	category-section-remove
Cc	cc
CertificateChecker_SignedContentError	certificate-checker-signed-content-error
Cf	cf
ChangeSignatureInputPage_unchanged	change-signature-input-page-unchanged
CheckoutAsMainPage_singleFolder	checkout-as-main-page-single-folder
ClasspathContainerDefaultPage_title	classpath-container-default-page-title
ClasspathContainerWizard_pagecreationerror_title	classpath-container-wizard-page-creation-error-title
Cn	cn
Co	co
CodePage	code-page
CodingStyleConfigurationBlock_new_button_desc	coding-style-configuration-block-new-button-desc
ColonColon	colon-colon
CommonFilterSelectionDialog_enter_name_of_filte_	common-filter-selection-dialog-enter-name-of-filte
CompCSEnclosingTextDetails_conclusion	comp-cs-enclosing-text-details-conclusion
CompCSMasterTreeSection_collapseAll	comp-cs-master-tree-section-collapse-all
CompareWithOtherResourceDialog_dialogTitle	compare-with-other-resource-dialog-dialog-title
CompilersConfigurationTab_buildPropertiesErrors	compilers-configuration-tab-build-properties-errors
ComplianceConfigurationBlock_codegen_targetplatform_label	compliance-configuration-block-codegen-target-platform-label
ComplianceConfigurationBlock_jrecompliance_info_project	compliance-configuration-block-jrecompliance-info-project
ConfigurationTemplateBlock_name	configuration-template-block-name
ConfigurationView_installPropDesc	configuration-view-install-prop-desc
ConfigurationView_replaceWith	configuration-view-replace-with
ConfiguredSitePropertyPage_enabled	configured-site-property-page-enabled
ConsolePreferencePage_Limit_console_output_1	console-preference-page-limit-console-output-1
Consumes	consumes
ContextHelpPart_more	context-help-part-more
CopyFailureList_problem	copy-failure-list-problem
CopyFilesAndFoldersOperation_missingLinkTarget	copy-files-and-folders-operation-missing-link-target
CopyFilesAndFoldersOperation_problemMessage	copy-files-and-folders-operation-problem-message
CorrectPackageDeclarationProposal_remove_description	correct-package-declaration-proposal-remove-description
Criteria_COLUMN	criteria-column
Cs	cs
D	d
DASHARG_DATABASE	dasharg-database
DATASIZE	data-size
DATA_CONTENT_TYPE	data-content-type
DATA_EXCEPTION_TRIM_ERROR	data-exception-trim-error
DATE_FORMAT_DATE_TIME	date-format-date-time
DAY_SIZE	day-size
DB	db
DB2_SQLTYPE_CHAR	db2-sqltype-char
DB2_SQLTYPE_NDBCLOB_LOCATOR	db2-sqltype-ndbclob-locator
DC	dc
DD	dd
DE	de
DEACTIVATED	deactivated
DEBUG_ANNOTATIONS	debug-annotations
DEBUG_BREAKPOINT_DELTAS	debug-breakpoint-deltas
DEBUG_CACHING	debug-caching
DEBUG_MESSAGE_BUNDLES	debug-message-bundles
DEBUG_OUTPUT	debug-output
DEBUG_SINGLE_STEP	debug-single-step
DECLARATION_VIEW	declaration-view
DEFAULT_ACTION_FOR_MODE	default-action-for-mode
DEFAULT_ACTIVATION_STATUS	default-activation-status
DEFAULT_DOCUMENT_CLASS_NAME	default-document-class-name
DEFAULT_ENTITY_EXPANSION_LIMIT	default-entity-expansion-limit
DEFAULT_ERROR_CANNOT_CANONIZE	default-error-cannot-canonize
DEFAULT_HONOUR_ALL_SCHEMA_LOCATIONS	default-honour-all-schema-locations
DEFAULT_IN_PROCESS_SHUTDOWN_COMMAND	default-in-process-shutdown-command
DEFAULT_LABEL_SHADOW_PAINT	default-label-shadow-paint
DEFAULT_LOG_NAME	default-log-name
DEFAULT_MAIN_METHOD_CLASS	default-main-method-class
DEFAULT_NAMESPACE_REMAP	default-namespace-remap
DEFAULT_OPENURL_TIMEOUT	default-openurl-timeout
DEFAULT_OUTLINE_PAINT_SEQUENCE	default-outline-paint-sequence
DEFAULT_PATH	default-path
DEFAULT_PROVIDER	default-provider
DEFAULT_RANGE_GRIDLINES_VISIBLE	default-range-gridlines-visible
DEFAULT_RPC_WHITELIST	default-rpc-whitelist
DEFAULT_TRACKED_LHS	default-tracked-lhs
DEFAULT_TRACKER_PORT	default-tracker-port
DEFAULT_VARIABLE_COLUMN_PRESENTATION	default-variable-column-presentation
DEFAULT_WSIMPORT_OPTIONS	default-wsimport-options
DEPLOYMENT_PROXY_HTTP_HOST	deployment-proxy-http-host
DEPLOY_PERF_LOG	deploy-perf-log
DEPS_VIEW_SHOW_CALLERS	deps-view-show-callers
DERIVATION_EXTENSION_RESTRICTION_SUBSTITION	derivation-extension-restriction-substition
DERIVED_ACTIVE_MIN_MILLIS	derived-active-min-millis
DESC_DEFCON_TOOL	desc-defcon-tool
DESC_EXP_OBJ	desc-exp-obj
DESC_TARGET_DEFINITION	desc-target-definition
DESTROY_EXISTING_RELATIONSHIPS	destroy-existing-relationships
DETAIL_FORMATTER_IS_DISABLED	detail-formatter-is-disabled
DETAIL_JSP	detail-jsp
DF	df
DH	dh
DI	di
DIAG_TO_STDOUT	diag-to-stdout
DIALOG_USE_PERSISTED_SIZE	dialog-use-persisted-size
DIALOG_WIDTH_WIN	dialog-width-win
DIRECTION_RIGHT_TO_LEFT	direction-right-to-left
DIRECT_CONNECTION_PROPERTY	direct-connection-property
DIR_DISTRIBUTION_SKELETON	dir-distribution-skeleton
DIR_VIEWS	dir-views
DISCRIMINATOR_PROPERTY_NAME	discriminator-property-name
DISCRIMINATOR_TAG	discriminator-tag
DISPLAY_COUNTRY	display-country
DISPLAY_QUALIFIED_NAMES	display-qualified-names
DL	dl
DN	dn
DND_COPY	dnd-copy
DO	do
DOCUMENT_FRAGMENT	document-fragment
DOCUMENT_GRAMMAR_BINDING_PROP	document-grammar-binding-prop
DOLLAR_ID_BASE	dollar-id-base
DOLOOP	do-loop
DOMAIN_XML_PATH	domain-xml-path
DOM_VK_PRINTSCREEN	dom-vk-printscreen
DOUBLE_ID	double-id
DOWNLOADSITE	download-site
DO_loadValues	do-load-values
DS	ds
DSComponentDetails_enabledLabel	ds-component-details-enabled-label
DSFileWizardPage_component_name	ds-file-wizard-page-component-name
DSProvideDetails_browse	ds-provide-details-browse
DSProvideSection_description	ds-provide-section-description
DSS_ID	dss-id
DSSimpPage_title	dss-imp-page-title
DT	dt
DURATION_SUMMARY_MAP	duration-summary-map
DX	dx
DYNAMIC_SELECTED	dynamic-selected
DaemonOff	daemon-off
DefaultLabelProvider_Breakpoint_1	default-label-provider-breakpoint-1
DependenciesViewPage_showOptional	dependencies-view-page-show-optional
DependencyPropertiesDialog_minimumVersion	dependency-properties-dialog-minimum-version
DetailsScreen_backCommand	details-screen-back-command
DirectoryBundleContainer_0	directory-bundle-container-0
DirectoryBundleContainer_1	directory-bundle-container-1
DirectoryBundleContainer_2	directory-bundle-container-2
DirectoryBundleContainer_3	directory-bundle-container-3
Do	do
DtDTS_DA_ACTION_LIST	dt-dts-da-action-list
DueDate	due-date
DuplicateAnnotation	duplicate-annotation
E	e
EC	ec
ECLIPSE_APP_CONTENTS	eclipse-app-contents
EDITOR_ANNOTATION_ROLL_OVER	editor-annotation-roll-over
EDITOR_FORMAT_JAVADOCS	editor-format-javadocs
EDITOR_ID	editor-id
EDITOR_JAVA_DEFAULT_BOLD	editor-java-default-bold
EG	eg
EJB_TYPE	ejb-type
EK_BCI	ek-bci
EK_BCO	ek-bco
EL	el
ELEMENT_CONCEPT_TREE	element-concept-tree
ELEMENT_LIB	element-lib
ELEMENT_ROOT	element-root
ELEMENT_chart	element-chart
ELEMENT_ganttDataset	element-gantt-dataset
ELEMENT_pieSeries	element-pie-series
ELEMNAME_ATTRIBUTE	elemname-attribute
ELEM_PROVIDER	elem-provider
EL_ACONTENT	el-acontent
EM	em
EMBEDDED_EJB_CONTAINER_PATH	embedded-ejb-container-path
EMPTY_PROPERTIES	empty-properties
EN	en
ENABLE_MIME_CONTENT_PROPERTY	enable-mime-content-property
ENCRYPTION_NOCHANGE_ALGORITHM	encryption-nochange-algorithm
ENDIF	endif
ENDOP	endop
END_REACHED	end-reached
ENQUEUED	enqueued
EO	eo
EQ	eq
EQUIVALENT	equivalent
ERROR_CANNOT_SET_MENU	error-cannot-set-menu
ERROR_CONTAINS_WRONG_CHAR_PROPERTY	error-contains-wrong-char-property
ERROR_IDENT	error-ident
ERR_FLUSH	err-flush
ERR_WORKING_DIRECTORY_NOT_SUPPORTED	err-working-directory-not-supported
ER_DUPLICATE_VAR	er-duplicate-var
ER_INCOMPATIBLE_TYPES	er-incompatible-types
ER_NON_ITERATOR_TYPE	er-non-iterator-type
ER_PATTERN_LITERAL_NEEDS_BE_QUOTED	er-pattern-literal-needs-be-quoted
ES	es
ESTABLISH_TRUST_IN_CLIENT	establish-trust-in-client
ET_STOPPED	et-stopped
EU	eu
EVAL_INLINE_SCRIPT	eval-inline-script
EVENT_SAVE_PARTICIPANTS	event-save-participants
EVENT_STATE_CHANGED	event-state-changed
EVT_SESSION_ACCESSED	evt-session-accessed
EX	ex
EXCS_CLASS_AND_INTERFACE_RESOLUTION	excs-class-and-interface-resolution
EXC_MIRROR_MAPPING_	exc-mirror-mapping
EXIT_EDGE	exit-edge
EXIT_PREFIX	exit-prefix
EXIT_UNKNOWN_OPTION	exit-unknown-option
EXPANDER_EXTRA_PADDING	expander-extra-padding
EXPRESSIONS_USE_PARENTHESES_ALWAYS	expressions-use-parentheses-always
EXP_TYPE_SYSTEM_PROPERTY	exp-type-system-property
EXTENSION_ACTION_SETS	extension-action-sets
EXTENSION_POINT_VARIABLE_VALUE_EDITORS	extension-point-variable-value-editors
EXTERNAL_LIB_PREFIX	external-lib-prefix
EXTERNAL_ROUTINE_EXCEPTION_MODIFYING_SQL_DATA_NOT_PERMITTED	external-routine-exception-modifying-sql-data-not-permitted
EXTRACT_INTERFACE	extract-interface
EXTRA_MENU_ROLE	extra-menu-role
EditOutputFolderAction_ErrorDescription	edit-output-folder-action-error-description
EditVMInstallWizard_0	edit-vm-install-wizard-0
Editor_FindIncremental_name	editor-find-incremental-name
EmulationPathToImplicitThis	emulation-path-to-implicit-this
EncryptionSpecNS	encryption-spec-ns
ExportTargetChooseFolder	export-target-choose-folder
ExtensionDetails_title	extension-details-title
ExternalizeWizard_name	externalize-wizard-name
ExtractInterfaceProcessor_existing_default_type	extract-interface-processor-existing-default-type
ExtractSupertypeProcessor_computing_possible_types	extract-super-typep-rocessor-computing-possible-types
F	f
F0	f-0
F1	f-1
F2	f-2
F3	f-3
F4	f-4
F5	f-5
F6	f-6
F7	f-7
F8	f-8
F9	f-9
FAILED_TO_PARSE	failed-to-parse
FARSI_YEH	farsi-yeh
FEATURE_PROVIDER	feature-provider
FETCHING_REVISION_DATA	fetching-revision-data
FF	ff
FIELDS_EXTENSION	fields-extension
FIELD_EXTEND_WITH	field-extend-with
FIELD_NONEXISTENT	field-nonexistent
FIELD_REF_WITH_CASTED_RECEIVER	field-ref-with-casted-receiver
FILE_LIST_DIRECTORY	file-list-directory
FILE_ONLY_PROPERTIES	file-only-properties
FILE_PATTERN_DELIMITERS	file-pattern-delimiters
FILL_METHOD_ARGUMENTS	fill-method-arguments
FINALLY_KEYWORD	finally-keyword
FIND_REPLACE_DIALOG	find-replace-dialog
FK	fk
FLAGS_FOCUSED_TRIANGLE	flags-focused-triangle
FLAG_CLOSED	flag-closed
FLAG_PERMANENT	flag-permanent
FLAG_PERSISTENT	flag-persistent
FLAG_RM	flag-rm
FLAG_UI	flag-ui
FLOWS_FROM_PROPERTY	flows-from-property
FM	fm
FNAME_TOKEN	fname-token
FOCUS_OUT_EVENT	focus-out-event
FOLDER_ICON	folder-icon
FOLDER_NEEDED_FOR_FILE_DELETIONS	folder-needed-for-file-deletions
FONT_CHANGE_SMALLER	font-change-smaller
FOREACHLOOP	for-each-loop
FORLOOP	for-loop
FORMAL_MODIFIER_KEY_COMPARATOR	formal-modifier-key-comparator
FORMATTER_COMMENT_INDENTROOTTAGS	formatter-comment-indentroottags
FORMATTER_INSERT_SPACE_AFTER_COMMA_IN_EXPLICIT_CONSTRUCTOR_CALL_ARGUMENTS	formatter-insert-space-after-comma-in-explicit-constructor-call-arguments
FORMAT_REMOVE_TRAILING_WHITESPACES_ALL	format-remove-trailing-whitespaces-all
FP	fp
FQ	fq
FR	fr
FRAGMENT_PLUGIN_MATCH	fragment-plugin-match
FRAGMENT_PLUGIN_MATCH_COMPATIBLE	fragment-plugin-match-compatible
FRAMEWORK_SECURITY	framework-security
FRAME_MINIMUM_HEIGHT_PROPERTY	frame-minimum-height-property
FREE_MEMORY_KEY	free-memory-key
FRIEND_DISCONNECTED	friend-disconnected
FROM_ESCAPED_UNICODE	from-escaped-unicode
FS	fs
FT_CORE	ft-core
FT_DISABLE_REQUEST_LIMITING	ft-disable-request-limiting
FULL_BUILD_ACTION	full-build-action
FUNCTION_TOKEN	function-token
FUNC_SUBSTRING_STRING	func-substring-string
F_FRIEND	f-friend
F_INTERNAL	f-internal
F_IS_CLASS	f-is-class
F_XML_IMP	f-xml-imp
FalseTrueList	false-true-list
Feature_SiteAlreadySet	feature-site-already-set
FileExport_destinationEmpty	file-export-destination-empty
FileImport_createVirtualFoldersTooltip	file-import-create-virtual-folders-tooltip
FillStippled	fill-stippled
FilteredItemsSelectionDialog_patternLabel	filtered-items-selection-dialog-pattern-label
FourByteAbgrPreX11	four-byte-abgr-pre-x11
G	g
G0	g-0
G1	g-1
G2	g-2
G3	g-3
G4	g-4
G5	g-5
G6	g-6
G7	g-7
GB	gb
GB2312_FIRST_CHAR	gb2312-first-char
GCFunction	gc-function
GDK_End	gdk-end
GDK_F10	gdk-f10
GDK_F11	gdk-f11
GDK_F12	gdk-f12
GDK_F13	gdk-f13
GDK_F14	gdk-f14
GDK_F15	gdk-f15
GDK_F16	gdk-f16
GDK_F17	gdk-f17
GDK_F18	gdk-f18
GDK_F19	gdk-f19
GDK_F20	gdk-f20
GDK_KP_Home	gdk-kp-home
GDK_WINDOW_TYPE_HINT_DIALOG	gdk-window-type-hint-dialog
GDS_ID	gds-id
GE	ge
GENERAL_DIALOG_FONT	general-dialog-font
GENERAL_STRING	general-string
GENERATOR_CHANGED	generator-changed
GENERIC_STRING_MAP_TYPE	generic-string-map-type
GEN_COLLECTED_HEAP	gen-collected-heap
GETPROTO	get-proto
GET_OBJECT_INSTANCE	get-object-instance
GET_THEME_DIR	get-theme-dir
GIOPFragment	giop-fragment
GIOPLocateReply	giop-locate-reply
GIOP_version	giop-version
GLX_TRANSPARENT_RED_VALUE_EXT	glx-transparent-red-value-ext
GLX_WINDOW_BIT	glx-window-bit
GM	gm
GNU_FAMILIY	gnu-familiy
GO	go
GOTO_WIDTH	goto-width
GRAILS_BASE_PROPERTY	grails-base-property
GRANT_NODE	grant-node
GRANT_ROLE_NODE	grant-role-node
GRID_SIZE	grid-size
GRP_FAST_VIEWS	grp-fast-views
GS	gs
GT	gt
GTK_EXPANDER_EXPANDED	gtk-expander-expanded
GWT_EXAMPLES	gwt-examples
GenerateHashCodeEqualsAction_label	generate-hash-code-equals-action-label
GenerateToStringDialog_templateManagerApplyButton	generate-to-string-dialog-template-manager-apply-button
GenerateToStringOperation_memberValueVariableDescription	generate-to-string-operation-member-value-variable-description
Gl	gl
Gy	gy
H	h
H0	h-0
H1	h-1
H2	h-2
H3	h-3
H4	h-4
H5	h-5
H6	h-6
H7	h-7
H8	h-8
H9	h-9
HANDLER_TYPE_UNKNOWN	handler-type-unknown
HARDNESS	hardness
HAS_ANY_RTL_RE	has-any-rtl-re
HAS_BOOTCLASSPATH	has-bootclasspath
HAVE_JAVA_14	have-java-14
HD	hd
HEADER_CACHE_CONTROL	header-cache-control
HEADER_COLOR	header-color
HEADER_MODE_DATA_STRING	header-mode-data-string
HELP_SERVICE_PORT_STUB_PROPERTY_POPUP	help-service-port-stub-property-popup
HG_IGNORE_CHG_ANY_FILES	hg-ignore-chg-any-files
HG_NO_CHANGES_ERR	hg-no-changes-err
HG_RESOLVE_CMD	hg-resolve-cmd
HI	hi
HIBERANTE_TRANSACTION_LOOKUP_CLASS	hiberante-transaction-lookup-class
HIDDEN	hidden
HIGHLIGHTED	highlighted
HKEY_CURRENT_USER	hkey-current-user
HORIZONTAL_MARGIN	horizontal-margin
HPROF_HEAP_DUMP_END	hprof-heap-dump-end
HR	hr
HT	ht
HTML_ATTREMPTY	html-attrempty
HTTP_CONTINUE	http-continue
HTTP_METHOD_PATTERN	http-method-pattern
HTTP_PROXY_TYPE	http-proxy-type
HYPERLINK_PRODUCER_FACTORY	hyperlink-producer-factory
HasUnresolvedSuperinterfaces	has-unresolved-superinterfaces
HelpTemplate_gettingStarted	help-template-getting-started
HistoryFilterDialog_fromDate	history-filter-dialog-from-date
Home	home
Host	host
HotSpotFunctionsFilterID	hot-spot-functions-filter-id
Hz	hz
I	i
I0	i-0
I1	i-1
I2	i-2
I3	i-3
I4	i-4
I5	i-5
I6	i-6
I7	i-7
IA	ia
ICON_BASE_ENTERPRISE_JAVA_BEANS_NODE	icon-base-enterprise-java-beans-node
ICON_BASE_MESSAGE_DRIVEN_NODE	icon-base-message-driven-node
ICON_SOURCE_BADGE	icon-source-badge
ID	id
IDENTITY_HASH_CODE	identity-hash-code
IDE_NAME	ide-name
IDL_JAVA_RMI_MODULE	idl-java-rmi-module
IDX_ACCESSOR_PACKAGE	idx-accessor-package
ID_AZ_PEER_EXCHANGE_BYTES	id-az-peer-exchange-bytes
ID_PIN_BUTTON	id-pin-button
ID_SOURCE_HOVER	id-source-hover
IE	ie
IF	if
IFNDEF	ifndef
IGNORE_STATUS_MARKED_FOR_ROLLBACK	ignore-status-marked-for-rollback
IGNORE_WHITESPACE	ignore-whitespace
IHDR_TYPE	ihdr-type
IHDR_filterMethodNames	ihdr-filter-method-names
IJ	ij
IM	im
IMAGE_BITMAP	image-bitmap
IMAGE_FILE_DLL	image-file-dll
IMAGE_FOLDER	image-folder
IMAP_SASL_AUTHORIZATIONID	imap-sasl-authorizationid
IMG_CONFLICT_OVR	img-conflict-ovr
IMG_DEC_FIELD_ERROR_QUICKFIX	img-dec-field-error-quickfix
IMG_ELCL_RESET_MEMORY	img-elcl-reset-memory
IMG_ETOOL_PIN_EDITOR	img-etool-pin-editor
IMG_FIELD_PROTECTED	img-field-protected
IMG_LCL_RUN_TO_LINE	img-lcl-run-to-line
IMG_OBJS_CLASSFOLDER_WSRC	img-objs-classfolder-wsrc
IMG_OBJS_CLASSPATH_VAR_ENTRY	img-objs-classpath-var-entry
IMG_OBJS_CONTENDED_MONITOR	img-objs-contended-monitor
IMG_OBJ_ACTIVITY_CATEGORY	img-obj-activity-category
IMG_TAG	img-tag
IMG_VIEW_CONSOLE	img-view-console
IMPDEP1	imp-dep-1
IMPDEP2	imp-dep-2
IMPLEMENTATION_NAME	implementation-name
IM_FEELING_LUCKY	im-feeling-lucky
IN	in
INCLUDES_FOLD	includes-fold
INCORRECT_JAVA_SPECVERSION_DIALOG_CAPTION	incorrect-java-specversion-dialog-caption
INCORRECT_TARGET_FOR_DECLARE_ANNOTATION	incorrect-target-for-declare-annotation
INDIRECTION_TAG	indirection-tag
INITIAL_VISUAL_GAP_LENGTH	initial-visual-gap-length
INITIAL_VOCABULARY_RESTRICTED_ALPHABETS_FLAG	initial-vocabulary-restricted-alphabets-flag
INIT_CODE_PRE	init-code-pre
INPUT_TAG	input-tag
INPUT_URL	input-url
INSERT_CONDITIONAL	insert-conditional
INSERT_PRIV	insert-priv
INSTALLER_PROFILEID	installer-profileid
INSTANCE_CPP	instance-cpp
INSTANCE_EXT	instance-ext
INTERFACE_REMOVED_TYPE_PARAMETER	interface-removed-type-parameter
INTERNAL_LOAD_NULLABLE	internal-load-nullable
INTERNAL_STATS	internal-stats
INTVAL_FRACTIONALMETRICS_ON	intval-fractional-metrics-on
INT_EMPTY_SET	int-empty-set
INT_LITERAL_ID	int-literal-id
INVALIDATE_CONTEXT	invalidate-context
INVALID_TYPES_OPERATION	invalid-types-operation
IN_EXPR_SQUOTES	in-expr-squotes
IO	io
IP	ip
IPAD	ipad
IPV4	ipv4
IPV6	ipv6
IPv4	ipv4
IPv6	ipv6
IREM	irem
IRUB	irub
IResourcePropertyConstants_name	i-resource-property-constants-name
IS	is
ISEM	isem
ISHL	ishl
ISHR	ishr
ISI_EL2_JUMP	isi-el2-jump
ISI_KEY_A_BSLASH	isi-key-a-bslash
ISSUE_TYPE	issue-type
ISUB	isub
IS_OS_WINDOWS_95	is-os-windows-95
IS_OS_WINDOWS_98	is-os-windows-98
IS_OS_WINDOWS_ME	is-os-windows-me
IS_SOLARIS	is-solaris
IS_VALIDATING	is-validating
IT	it
ITEM	item
ITEM_Float	item-float
ITEM_VIEW_FLAVOR	item-view-flavor
ITER	iter
ITERATIONS	iterations
IU	iu
IUCopyrightPropertyPage_ViewLinkLabel	iu-copyright-property-page-view-link-label
IV	iv
I_	i
Icode_ELEM_AND_THIS	i-code-elem-and-this
Id	id
IdAttributeRow_title	id-attribute-row-title
Id_getTime	id-get-time
Id_getUTCMinutes	id-get-utc-minutes
Id_isNaN	id-is-nan
Id_small	id-small
Id_some	id-some
Id_sort	id-sort
Id_sqrt	id-sqrt
Id_toUpperCase	id-to-upper-case
If	if
IgnoreLeadingPathSegmentsDialog_numberOutOfRange	ignore-leading-path-segments-dialog-number-out-of-range
IgnoreResourcesDialog_patternDoesNotMatchFile	ignore-resources-dialog-pattern-does-not-match-file
ImportPage_filterSelections	import-page-filter-selections
ImportProjectSetMainPage_workingSetLabel	import-project-set-main-page-working-set-label
ImportTypeDialog_titleFilesLinking	import-type-dialog-title-files-linking
In	in
InheritedMethodReducesVisibility	inherited-method-reduces-visibility
InlineTempInputPage_message_one	inline-temp-input-page-message-one
InstanceType	instance-type
InternalAntRunner_Build_file	internal-ant-runner-build-file
Intro_could_not_create_part	intro-could-not-create-part
InvalidityDate_Id	invalidity-date-id
Is	is
J	j
J2ME	j2me
J2SE	j2se
JAR_MIME_TYPE_NEW	jar-mime-type-new
JAVA6_PACKAGE_MINOR_VERSION	java6-package-minor-version
JAVAC_TARGET	javac-target
JAVADOC_COMMAND_HISTORY	javadoc-command-history
JAVADOC_SPECIFICS_PAGE	javadoc-specifics-page
JAVAHL_INIT_SUCCESS	javahl-init-success
JAVAWS_JRE_OS_ARCH	javaws-jre-os-arch
JAVA_PROXY_TYPE	java-proxy-type
JAWT_LOCK_BOUNDS_CHANGED	jawt-lock-bounds-changed
JDBC_METHOD_NOT_SUPPORTED_BY_SERVER	jdbc-method-not-supported-by-server
JDILocalVariable_exception_retrieving_local_variable_type_name	jdi-local-variable-exception-retrieving-local-variable-type-name
JDK_1_7_VERSION	jdk-1-7-version
JIT_CODE_CACHE	jit-code-cache
JL	jl
JMX_IMPL_VENDOR	jmx-impl-vendor
JPEG_MIME_TYPE	jpeg-mime-type
JREContainerResolution_Select_a_system_library_to_use_when_building__0__2	jre-container-resolution-select-a-system-library-to-use-when-building-0-2
JS	js
JSF_IMPL_JAR	jsf-impl-jar
JTAResource	jta-resource
JTA_TRANSACTION_MANAGER_CLASS_NAME	jta-transaction-manager-class-name
JUNIT_SUPER_CLASS_NAME	junit-super-class-name
JUnitAddLibraryProposal_cannotAdd	junit-add-library-proposal-cannot-add
JVM_ARGS	jvm-args
JVM_ARGS_PROPERTY	jvm-args-property
JVM_STARTED_ID	jvm-started-id
JarFileExportOperation_exportedWithCompileWarnings	jar-file-export-operation-exported-with-compile-warnings
JarFileExportOperation_resourceNotFound	jar-file-export-operation-resource-not-found
JarImportWizardPage_import_message	jar-import-wizard-page-import-message
JarPackageWizard_windowTitle	jar-package-wizard-window-title
JarVerificationDialog_CorruptedContent_Feature	jar-verification-dialog-corrupted-content-feature
JarVerificationDialog_FileName	jar-verification-dialog-file-name
JavaCompareWithEditionActionImpl_0	java-compare-with-edition-action-impl-0
JavaContextType_variable_description_todo	java-context-type-variable-description-todo
JavaDebugPreferencePage_Display_ASCII__character_values__byte__short__int__long__4	java-debug-preference-page-display-ascii-character-values-byte-short-int-long-4
JavaEditorPreferencePage_foregroundForCompletionReplacement	java-editor-preference-page-foreground-for-completion-replacement
JavaEditorPreferencePage_javaDocHtmlTags	java-editor-preference-page-javadoc-html-tags
JavaEditorPreferencePage_typing_smartSemicolon	java-editor-preference-page-typing-smart-semicolon
JavaElementInfoPage_not_present	java-element-info-page-not-present
JavaElementInfoPage_package_contents	java-element-info-page-package-contents
JavaOutlinePage_Sort_tooltip	java-outline-page-sort-tooltip
JavadocTreeWizardPage_destinationbrowsedialog_label	javadoc-tree-wizard-page-destination-browse-dialog-label
JavadocTreeWizardPage_destinationbrowsedialog_title	javadoc-tree-wizard-page-destination-browse-dialog-title
JavadocUndefinedMethod	javadoc-undefined-method
JvmThreadCpuTimeMonitoringDisabled	jvm-thread-cpu-time-monitoring-disabled
K	k
KA	ka
KB	kb
KENAI_WEB_SOURCES_REVISION_PATH	kenai-web-sources-revision-path
KEYWORD_CHAR	keyword-char
KEYWORD_COLLECT	keyword-collect
KEY_COLUMN	key-column
KEY_RELEASED	key-released
KEY_RIGHT	key-right
KF	kf
KG	kg
KS	ks
KT_ORGANIZATIONAL	kt-organizational
KW	kw
L	l
L0	l-0
L1	l-1
L2	l-2
L3	l-3
L4	l-4
L5	l-5
L6	l-6
L7	l-7
LA	la
LABEL_INSN	label-insn
LANG_DB2_LENGTH_PRECISION_SCALE_VIOLATION	lang-db2-length-precision-scale-violation
LANG_INVALID_COLUMN_TYPE_CREATE_TABLE	lang-invalid-column-type-create-table
LANG_INVALID_NUMBER_FORMAT_FOR_OVERRIDE	lang-invalid-number-format-for-override
LANG_JAVACC_LEXICAL_ERROR	lang-javacc-lexical-error
LANG_NO_SUCH_WINDOW	lang-no-such-window
LANG_TRIGGER_BAD_REF_MISMATCH	lang-trigger-bad-ref-mismatch
LAST_USED_BIT	last-used-bit
LB	lb
LBRACKET_ID	lbracket-id
LC	lc
LD	ld
LDAP_INVALID_CREDENTIALS	ldap-invalid-credentials
LDAP_REQ_COMPARE	ldap-req-compare
LE	le
LEFT_WHITESPACE	left-whitespace
LF	lf
LI	li
LIBRARY_LOCATIONS	library-locations
LIB_PLUGIN	lib-plugin
LIFE_TIME	life-time
LINE_BREAK	line-break
LINK_DISTANCE	link-distance
LINK_TYPE	link-type
LISTEN_SOCKET_PROPERTY	listen-socket-property
LL	ll
LN	ln
LOADING_RENDERER	loading-renderer
LOADSTARTED	load-started
LOCAL_VARIABLE_TARGET	local-variable-target
LOG10_2	log10-2
LOG_FILE_OPTION	log-file-option
LOG_INCOMPATIBLE_VERSION	log-incompatible-version
LOG_LEVEL_KEY	log-level-key
LOG_LOCK	log-lock
LONGINT_TYPE_ID	longint-type-id
LOOKUPLENGTH	lookup-length
LP	lp
LPAREN_INT	lparen-int
LR	lr
LS	ls
LT	lt
LV	lv
LValuesCoded	l-values-coded
LW	lw
LWA_ALPHA	lwa-alpha
LauncherSection_solarisLabel	launcher-section-solaris-label
LibrariesWorkbookPage_libraries_addextjar_button	libraries-workbook-page-libraries-add-ext-jar-button
Ll	ll
Lm	lm
Lo	lo
LoadTargetDefinitionJob_0	load-target-definition-job-0
LoadTargetDefinitionJob_1	load-target-definition-job-1
LocalEvaluationEngine_Evaluation_failed___unable_to_initialize_local_variables__4	local-evaluation-engine-evaluation-failed-unable-to-initialize-local-variables-4
LocalEvaluationEngine_Evaluation_failed___unable_to_initialize_local_variables__6	local-evaluation-engine-evaluation-failed-unable-to-initialize-local-variables-6
LogView_show_filter_text	log-view-show-filter-text
Lt	lt
Lu	lu
M	m
M1	m-1
M2	m-2
MAIN_COMPONENT_TYPEID_ATTR	main-component-typeid-attr
MAKE_BID_CMD	make-bid-cmd
MANAGED_ONLY	managed-only
MANIFEST_VERSION	manifest-version
MAPPED_IMAGE_FILE_TAG	mapped-image-file-tag
MAPPING_INDEX_PREFIX_LENGTH	mapping-index-prefix-length
MARKERS_ID	markers-id
MARKER_ATT_KEY	marker-att-key
MARK_COLLECTION	mark-collection
MASK_NAME_START	mask-name-start
MASTER_LOCK	master-lock
MAX_ACTIVE_CONNECTIONS	max-active-connections
MAX_LINES_TO_PRINT	max-lines-to-print
MAX_QUEUE_SIZE	max-queue-size
MAX_SIZE_FILE_KEY	max-size-file-key
MB	mb
MBEANSERVERDELEGATE	m-bean-server-delegate
MBEAN_COUNT	mbean-count
MD	md
MD5_STR	md5-str
MD5_SUM	md5-sum
MEMATTR_MPROP_STATIC	memattr-mprop-static
MEMBER_ACCESSES_NON_STATIC_METHOD_USE_THIS_ALWAYS	member-accesses-non-static-method-use-this-always
MEMBER_SINGLETON	member-singleton
MEMBER_VALUE_IDX	member-value-idx
MEM_STREAM_SIZE	mem-stream-size
MENU_ID_BETA_PROG	menu-id-beta-prog
MERGE_FORCED_UPDATE_ACTION	merge-forced-update-action
MERGE_UPDATE_CONFLICTING_ADDITION_MATCHER	merge-update-conflicting-addition-matcher
MESSAGE_DRIVEN_BEAN	message-driven-bean
METADATA_FOLDER	metadata-folder
META_ELEMENT	meta-element
METHOD_NODE_FLAVOR	method-node-flavor
METHOD_WITH_DEFAULT_VALUE	method-with-default-value
MIME_TYPE	mime-type
MINIMISE_OVERHEADS	minimise-overheads
MINWIDTH	min-width
MIN_JAMO_V	min-jamo-v
MIN_JAVA_VERSION_WINDOWS_VISTA	min-java-version-windows-vista
MIN_UPDATE_PERIOD_DEFAULT	min-update-period-default
ML	ml
MM	mm
MO	mo
MODEL_LISTENER	model-listener
MODE_GROUP	mode-group
MODE_READWRITE_FIELD_NAME	mode-readwrite-field-name
MR	mr
MR_OWL_CONTENT_TYPE_JARNAL	mr-owl-content-type-jarnal
MS	ms
MSG_FOLDER_EXISTS	msg-folder-exists
MSG_OUTPUT_DIR_IS_FILE	msg-output-dir-is-file
MSG_RULE_REF_AMBIG_WITH_RULE_IN_ALT	msg-rule-ref-ambig-with-rule-in-alt
MSG_UNKNOWN_ATTRIBUTE_IN_SCOPE	msg-unknown-attribute-in-scope
MThd_MAGIC	m-thd-magic
MULTIPLE_RESULTS_ON_EXECUTE_QUERY	multiple-results-on-execute-query
MULTIPROJECTPATCH_PROJECT	multi-project-patch-project
MUST_CALIBRATE_FIRST_MSG	must-calibrate-first-msg
MWM_FUNC_MOVE	mwm-func-move
M_PROJECT	m-project
M_SINGLETON_ATT_NOT_SET	m-singleton-att-not-set
MatchLocations_super_types_description	match-locations-super-types-description
Mc	mc
Me	me
MemberVisibilityAdjustor_change_visibility_private	member-visibility-adjustor-change-visibility-private
MemoryBlocksTreeViewPane_0	memory-blocks-tree-view-pane-0
MemoryBlocksTreeViewPane_1	memory-blocks-tree-view-pane-1
MemoryBlocksTreeViewPane_2	memory-blocks-tree-view-pane-2
MethodExecution	method-execution
Minus	minus
MissingArgumentsForParameterizedMemberType	missing-arguments-for-parameterized-member-type
Mn	mn
Modify	modify
N	n
NA	na
NAME_GENERATOR_ATTRIBUTE	name-generator-attribute
NBM_ORIGIN	nbm-origin
NB_HOME_PROPERTY	nb-home-property
NCNAME_CHARACTER	ncname-character
NE	ne
NET_DSS_NOT_ZERO	net-dss-not-zero
NET_SECTKN_NOT_RETURNED	net-sectkn-not-returned
NEW_CLASS_WIZARD_PAGE	new-class-wizard-page
NEXT_COLUMN_EXTEND_SELECTION	next-column-extend-selection
NF	nf
NL	nl
NLS_TITLE_LANGUAGE	nls-title-language
NN	nn
NNTP_PORT	nntp-port
NO	no
NOARGS	no-args
NODEPRECATED	no-deprecated
NODE_LIST_MIME_TYPE	node-list-mime-type
NODE_WIDTH	node-width
NODE_fontFamily	node-font-family
NON_EXISTING_DIRS	non-existing-dirs
NOOP_INSTANTIATOR	noop-instantiator
NOTIFYREM	notify-rem
NOTIFY_FILTERS	notify-filters
NOT_BEFORE	not-before
NOT_FUTURE	not-future
NOT_GIVEN	not-given
NOT_SPECIAL	not-special
NO_MODIFIERS	no-modifiers
NO_REPAIR	no-repair
NO_SERVICES	no-services
NR	nr
NS	ns
NSCONSTRAINT_NOT	nsconstraint-not
NSCT_S_MIME	nsct-s-mime
NS_IDOWNLOAD_IID_STR	ns-idownload-iid-str
NS_ITRANSFER_IID	ns-itransfer-iid
NS_IWEBNAVIGATION_IID	ns-iwebnavigation-iid
NT	nt
NULLCHECK_LOCKED	nullcheck-locked
NULLTAG	null-tag
NULL_ARG	null-arg
NULL_ARRAY	null-array
NULL_DOC	null-doc
NULL_TIMESTAMP	null-timestamp
NUMBERLEVEL_MULTI	numberlevel-multi
NUM_COLOR_ID	num-color-id
NUM_CONTEXT_OPCODES	num-context-opcodes
NUM_JCS_CODES	num-jcs-codes
NUM_VIRTUAL_FORMATTERS	num-virtual-formatters
Nd	nd
NewAnnotationWizardPage_title	new-annotation-wizard-page-title
NewClassWizardPage_methods_inherited	new-class-wizard-page-methods-inherited
NewExtensionWizard_PointSelectionPage_templateDescription	new-extension-wizard-point-selection-page-template-description
NewFolderDialog_folderNameEmpty_alreadyExists	new-folder-dialog-folder-name-empty-already-exists
NewPackageWizardPage_info	new-package-wizard-page-info
NewProject_perspSwitchMessage	new-project-persp-switch-message
NewTestSuiteWizPage_createType_updateErrorDialog_title	new-test-suite-wiz-page-create-type-update-error-dialog-title
NewTypeWizardPage_error_uri_location_unkown	new-type-wizard-page-error-uri-location-unkown
Nl	nl
No	no
NoCorrectionProposal_description	no-correction-proposal-description
NoField	no-field
NoInterface	no-interface
NoValue	no-value
Notes	notes
Numeric_KIND	numeric-kind
O	o
O0	o-0
O1	o-1
O2	o-2
O3	o-3
O4	o-4
O5	o-5
O6	o-6
O7	o-7
OA	oa
OBJECTNAME	object-name
OBJECT_HASHCODE_VARIABLE	object-hashcode-variable
OBJ_ALLOC_STACK_TRACE	obj-alloc-stack-trace
OBSERVED_OBJECT_ERROR_NOTIFIED	observed-object-error-notified
OCTET_STRING_LENGTH_LARGE_FLAG	octet-string-length-large-flag
OD	od
OF	of
OFMSG_FILE_NOT_EXISTS	ofmsg-file-not-exists
OI	oi
OID_EKU_MS_SGC	oid-eku-ms-sgc
OK	ok
OK_BUTTON_TEXT	ok-button-text
OL	ol
ON	on
ONE_PAGE	one-page
OO	oo
OOM_CATCH_LEN	oom-catch-len
OP	op
OPC_iconst_0	opc-iconst-0
OPC_iconst_1	opc-iconst-1
OPC_iconst_2	opc-iconst-2
OPC_iconst_3	opc-iconst-3
OPC_iconst_4	opc-iconst-4
OPC_iconst_5	opc-iconst-5
OPC_lushr	opc-lushr
OPENMODE_FORUPDATE	open-mode-for-update
OPR_ENABLED_KEY	opr-enabled-key
OPTIONS_VISIBLE_DEFAULT	options-visible-default
OPTION_PLATFORM_ADMIN	option-platform-admin
OPTION_ReportFallthroughCase	option-report-fallthrough-case
OPTION_TaskPriorities	option-task-priorities
OP_BASE	op-base
OP_DELETE_TEMPLATE	op-delete-template
OR	or
ORDER_BY_LIST_NAME	order-by-list-name
ORIENTATION_CENTER	orientation-center
ORIGINAL_TRAILING_SLASHES_COUNT_METADATA_KEY	original-trailing-slashes-count-metadata-key
OS	os
OSGI_INF_PATH	osgi-inf-path
OSGiSimpleLogServiceTemplate_pageTitle	osgi-simple-log-service-template-page-title
OS_OFFSET	os-offset
OS_WINDOWS	os-windows
OTHER_OVERRIDES	other-overrides
OU	ou
OUTCODE_LEFT	outcode-left
OUTPUT_PROPERTY	output-property
OUTSIDE1	outside-1
OUTSIDE2	outside-2
OUTSIDE3	outside-3
OUTSIDE4	outside-4
OUTSIDE5	outside-5
OUTSIDE6	outside-6
OUTSIDE7	outside-7
OUTSIDE8	outside-8
OUTSIDE9	outside-9
OX	ox
OffsetRow	offset-row
On	on
Op	op
Or	or
Ox	ox
P	p
P0	p-0
P2	p-2
P3	p-3
P4	p-4
P5	p-5
P6	p-6
P7	p-7
PA	pa
PALE_TURQUOISE	pale-turquoise
PARAMETERS_ATTR	parameters-attr
PARAMETER_MODE_UNKNOWN	parameter-mode-unknown
PARAMETER_TARGET	parameter-target
PARAM_FEATUREID	param-featureid
PARAM_ID_CHEAT_SHEET_ID	param-id-cheat-sheet-id
PARAM_NULL_RESOURCE_PATH	param-null-resource-path
PARAM_PIM_LIST_TYPE	param-pim-list-type
PARM_BACKUP	parm-backup
PARM_MODE	parm-mode
PARM_PHASE_ID	parm-phase-id
PATH_IN_WAR_DIR	path-in-war-dir
PATH_MODE	path-mode
PATTERN_1	pattern-1
PATTERN_2	pattern-2
PATTERN_3	pattern-3
PATTERN_4	pattern-4
PATTERN_DELIMITER	pattern-delimiter
PATTERN_SEPARATOR_CHAR	pattern-separator-char
PC	pc
PD	pd
PEER_RECHECK_PERIOD	peer-recheck-period
PERFDATA_PROLOG_MINOR_SIZE	perfdata-prolog-minor-size
PERSISTENCE_TAG	persistence-tag
PERSP_TOP_RIGHT_TITLE	persp-top-right-title
PEV_INITIALISATION_PROGRESS_PERCENT	pev-initialisation-progress-percent
PHP_PALETTE_FOLDER	php-palette-folder
PHP_UNIT	php-unit
PI	pi
PID_DHT	pid-dht
PID_PLATFORM_CHECKER	pid-platform-checker
PI_END_ID	pi-end-id
PI_START_ID	pi-start-id
PK	pk
PLATFORM_WINDOWS_OS	platform-windows-os
PLUGINS_NOT_ACTIVATED_ON_STARTUP	plugins-not-activated-on-startup
PLUGIN_RESOURCE_ID	plugin-resource-id
PLUGIN_VERSION	plugin-version
PM	pm
PMF_CREATE_NON_RETAIN	pmf-create-non-retain
POINT_ID	point-id
POLICY_REPORT	policy-report
POST_RESOURCES	post-resources
POS_0_MASK	pos-0-mask
PPOINTS_DEPENDENCIES_INCLUDE_DEFAULT	ppoints-dependencies-include-default
PPosition	p-position
PR	pr
PREFIX_KEYRING_KEY	prefix-keyring-key
PREFIX_THREAD_LOCAL	prefix-thread-local
PREF_PB_INVALID_JAVADOC_TAGS_NOT_VISIBLE_REF	pref-pb-invalid-javadoc-tags-not-visible-ref
PREF_SHOW_HASREMOTE_DECORATION	pref-show-has-remote-decoration
PREF_SOURCE_FILE_ATTR	pref-source-file-attr
PREF_SPELLING_ENABLE_CONTENTASSIST	pref-spelling-enable-contentassist
PREF_WATCH_EXPRESSIONS	pref-watch-expressions
PREPEND_CHILD	prepend-child
PRIMARYORDERSHIFT	primary-order-shift
PRINCIPALNAMECLASSNAME	principal-name-class-name
PRINTING_TAB	printing-tab
PRINT_DBB_POOL_USAGE	print-dbb-pool-usage
PRIVATE_ACCESS	private-access
PROBLEM_NAME_INVALID	problem-name-invalid
PROFILE_TARGET_ATTRIBUTE	profile-target-attribute
PROFILING_RUNNING	profiling-running
PROF_SAMLSENDER	prof-samlsender
PROJECT_CLOSE_PROJECT	project-close-project
PROJECT_END_CHAR	project-end-char
PROJECT_SELECTION	project-selection
PROJECT_TAG	project-tag
PROJECT_XML	project-xml
PROPERTY_CATEGORY_AXIS_TICK_LABEL_COLOR	property-category-axis-tick-label-color
PROPERTY_IGNORE_GRAPHICS	property-ignore-graphics
PROPERTY_MEMORY_THRESHOLD	property-memory-threshold
PROPERTY_METER_ANGLE	property-meter-angle
PROPERTY_NAME_COLOR	property-name-color
PROPERTY_NEEDLE_COLOR	property-needle-color
PROPERTY_PERCENTAGE_OF_TYPE	property-percentage-of-type
PROPERTY_SORTING_MODE	property-sorting-mode
PROPERTY_TIME_AXIS_LABEL_FONT	property-time-axis-label-font
PROPERTY_TITLE_COLOR	property-title-color
PROPOSAL_MODE_PROPERTY_PROPOSAL	proposal-mode-property-proposal
PROP_ABSTRACT	prop-abstract
PROP_APPLY_GRID_TO_POSITION	prop-apply-grid-to-position
PROP_BLOCK	prop-block
PROP_CHANGED	prop-changed
PROP_COMBINATION_TOOLTIP_TEXT_KEY	prop-combination-tooltip-text-key
PROP_CUSTOM_DEFS	prop-custom-defs
PROP_DELETED	prop-deleted
PROP_EXCLUSION_PATTERNS	prop-exclusion-patterns
PROP_FORCE_STOP	prop-force-stop
PROP_FROM_OPEN_PROJECTS	prop-from-open-projects
PROP_GC_MAX	prop-gc-max
PROP_INDEX_BASED_SWITCH	prop-index-based-switch
PROP_INFO_NOTIFICATION	prop-info-notification
PROP_LAST_NODES	prop-last-nodes
PROP_MENU_LABEL	prop-menu-label
PROP_NAME_INDEX	prop-name-index
PROP_OSGI_BUNDLES	prop-osgi-bundles
PROP_OWNING_SOURCE_ROOT_URL	prop-owning-source-root-url
PROP_PHP_DEBUGGER_SESSION_ID	prop-php-debugger-session-id
PROP_REGISTER_PERF_SERVICE	prop-register-perf-service
PROP_SHARED_LIB_LOADED	prop-shared-lib-loaded
PROP_SHELL_COMMAND	prop-shell-command
PROP_SIP_SSL_PORT	prop-sip-ssl-port
PROP_SPACE_BEFORE_SWITCH_PAREN	prop-space-before-switch-paren
PROP_STATUS	prop-status
PROP_SUBCLASSES	prop-subclasses
PROP_SUPERCLASS	prop-superclass
PROP_TARGET_MAPPINGS	prop-target-mappings
PROP_WORK_DIR	prop-work-dir
PROTOCOL_UNKNOWN	protocol-unknown
PROXY_TEMPLATE	proxy-template
PROX_HTTP_PORT_KEY	prox-http-port-key
PS	ps
PT_CLOSE_OR_RESTART_ALREADY_IN_PROGRESS	pt-close-or-restart-already-in-progress
PT_TORRENT_ATTRIBUTE_WRITTEN	pt-torrent-attribute-written
PUBLIC_ID_HELPCTX	public-id-helpctx
PUMPING_UPDATED_KEY	pumping-updated-key
PUTFIELD_QUICK_W	putfield-quick-w
PV_FIELD_PRODUCT	pv-field-product
PX	px
PY	py
P_HEADER_ATTRIBUTES	p-header-attributes
P_HEADER_KEY	p-header-key
P_IMPORT_ORDER	p-import-order
P_ITALIC_SUFFIX	p-italic-suffix
P_LOG_ERROR	p-log-error
P_RESOLVED_LOCATION_RES	p-resolved-location-res
P_TRUE	p-true
P_UNKNOWN_ATTRIBUTE	p-unknown-attribute
P_VALUE	p-value
Pa	pa
PackageExplorerActionGroup_FormText_UnexcludeFile	package-explorer-action-group-form-text-unexclude-file
Packages	packages
ParameterEditDialog_defaultValue_error	parameter-edit-dialog-default-value-error
PartPane_size	part-pane-size
PathVariableDialog_selectFolderMessage	path-variable-dialog-select-folder-message
PatternSelectionPage_package_pattern	pattern-selection-page-package-pattern
PauseHierarchyCheck	pause-hierarchy-check
Pc	pc
Pd	pd
Pe	pe
Period	period
Pf	pf
Pi	pi
PictTypeDirect	pict-type-direct
PlaceOnTop	place-on-top
PlatformLineDelimiter	platform-line-delimiter
PluginsView_asSourceProject	plugins-view-as-source-project
PluginsView_dependentPlugins	plugins-view-dependent-plugins
PlusPlus	plus-plus
Po	po
PointerToSymbolTable	pointer-to-symbol-table
Preferences_MainPage_Description	preferences-main-page-description
PreviewPatchPage2_IgnoreWhitespace	preview-patch-page2-ignore-whitespace
ProblemSeveritiesConfigurationBlock_pb_accidential_assignement_label	problem-severities-configuration-block-pb-accidential-assignement-label
ProblemSeveritiesConfigurationBlock_pb_indirect_access_to_static_label	problem-severities-configuration-block-pb-indirect-access-to-static-label
ProjectSwitchPerspectiveMode_prompt	project-switch-perspective-mode-prompt
ProjectUpdateChange_project_not_accessible	project-update-change-project-not-accessible
PromoteTempToFieldRefactoring_method_parameters	promote-temp-to-field-refactoring-method-parameters
Ps	ps
PullUpRefactoring_field_not_accessible	pull-up-refactoring-field-not-accessible
Py_UNICODE_REPLACEMENT_CHARACTER	py-unicode-replacement-character
Q	q
Q01_POS	q01-pos
QC_NFC	qc-nfc
QC_NFD	qc-nfd
QNAME_ALL	qname-all
QNAME_ANY	qname-any
QNAME_CLASS	qname-class
QNAME_INCLUDE	qname-include
QNAME_TOKEN	qname-token
QNAME_TYPE_DOUBLE	qname-type-double
QNAME_TYPE_ENTITIES	qname-type-entities
QUALIFIED_ID_DELIMETER	qualified-id-delimeter
QUALIFY_REFERENCES	qualify-references
QUICK_START_ACTION	quick-start-action
R	r
R0	r-0
R1	r-1
R2	r-2
R8	r-8
R9	r-9
RADIAL_GRADIENT	radial-gradient
RAILS_TEST_DB	rails-test-db
RB	rb
RC	rc
RCSID	rcs-id
RD	rd
RDTICK	rd-tick
READER_CLOSED	reader-closed
REAL_TYPE_ID_IMPL	real-type-id-impl
RECEIVER_INDEX	receiver-index
RECENT_REPORTS_HISTORY_MAX	recent-reports-history-max
REFERENCE_REQUEST	reference-request
RELATED_TOKEN	related-token
REMOTE_ANT_LOGGER_CLASS	remote-ant-logger-class
REMOVE_DELIM	remove-delim
REMOVE_MAPPER_EVENT	remove-mapper-event
RENAME_ENTRY	rename-entry
REPLACE_LABEL	replace-label
REPLACING_EXISTING_METHOD	replacing-existing-method
REQUEST_PARTITIONING_POLICY	request-partitioning-policy
REQUIRECANCELSCT	require-cancels-ct
REQUIRED_PER_FULL_GC	required-per-full-gc
REQUIRE_AUTHENTICATION_PARAMETER	require-authentication-parameter
RESERVED_CHARACTERS	reserved-characters
RESERVED_TYPE_BOOLEAN	reserved-type-boolean
RESOLVE_CLASS_METHODS	resolve-class-methods
RESOURCES_STANDARDLINKSTYLE	resources-standard-link-style
RESOURCE_ADAPTER_CONFIG	resource-adapter-config
RESOURCE_LOADER	resource-loader
RESTART_ACTION	restart-action
RESTRICT_TO_MATCHING_CASE	restrict-to-matching-case
RESULTS_IN_DROP_DOWN	results-in-drop-down
RG	rg
RI	ri
RLO_GROUP_LID	rlo-group-lid
RO	ro
ROLE_BUTTON	role-button
ROLE_CALENDAR	role-calendar
RP	rp
RQ	rq
RS	rs
RU	ru
RV	rv
RX	rx
RebuildAction_text	rebuild-action-text
RemoteFileEditorInput_fullPathAndRevision	remote-file-editor-input-full-path-and-revision
RemoteFolder_doesNotExist	remote-folder-does-not-exist
RemoveBookmark_toolTip	remove-bookmark-tool-tip
RemoveBuildOrderEntries_label	remove-build-order-entries-label
RemoveRootAction_RepositoryRemovalDialogMessageSingle	remove-root-action-repository-removal-dialog-message-single
RenameInformationPopup_snap_under_left	rename-information-popup-snap-under-left
RenameMethodUserInterfaceStarter_message	rename-method-user-interface-starter-message
ReorgPolicyFactory_copy_files	reorg-policy-factory-copy-files
RepositoryManipulationPage_Add	repository-manipulation-page-add
RequestDispatcherRegistry_ERROR	request-dispatcher-registry-error
Resolve_text	resolve-text
ResourceDeltaVisitor_visitError	resource-delta-visitor-visit-error
ResourceInfo_fileContentEncodingFormat	resource-info-file-content-encoding-format
ResourceInfo_owner	resource-info-owner
RestoreFromRepositoryAction_noFilesTitle	restore-from-repository-action-no-files-title
ReturnTypeAmbiguous	return-type-ambiguous
ReturnTypeInternalNameProvided	return-type-internal-name-provided
Rl	rl
Rn	rn
S	s
S0	s-0
S1	s-1
S2	s-2
S3	s-3
S4	s-4
S5	s-5
S6	s-6
SAMPLING_PERIOD_STRING	sampling-period-string
SASH_WEIGHT_TREE	sash-weight-tree
SASH_WIDTH	sash-width
SASTORE	sa-store
SAVE_POLICY_FILE	save-policy-file
SB	sb
SC	sc
SCHEMA_COL	schema-col
SCHEMA_CSS	schema-css
SCHEMA_DIR	schema-dir
SCI_ATTACHMENT_NAME	sci-attachment-name
SC_REQ_ACCEPT_LANGUAGE	sc-req-accept-language
SD	sd
SE	se
SEARCH_HEAVYWEIGHTS	search-heavyweights
SECURITY_REF_QNAME	security-ref-qname
SELECTED_ICON_CHANGED_PROPERTY	selected-icon-changed-property
SELECTOR_OUTLINE	selector-outline
SELECT_FILE_TASK_LABEL_STRING	select-file-task-label-string
SERVER_ABORTED_MESSAGE_PREFIX	server-aborted-message-prefix
SERVER_INSTANCE_SUN_APPSERVER	server-instance-sun-appserver
SETTER_NAME	setter-name
SET_EXTRACT_INTERFACE	set-extract-interface
SET_SELECTED_PERIOD	set-selected-period
SF	sf
SH	sh
SHA1_ALGID	sha1-algid
SHORTcode	short-code
SHRINK_DOWN	shrink-down
SI	si
SIGC_BOOLEAN	sigc-boolean
SIG_BYTE	sig-byte
SIMPLE_RTF	simple-rtf
SINGLE_SLASH	single-slash
SIZING_SELECTION_PANE_WIDTH	sizing-selection-pane-width
SKIP_ID	skip-id
SKIP_LF	skip-lf
SL	sl
SN	sn
SNMP_ACL_FILE_NOT_FOUND	snmp-acl-file-not-found
SO	so
SOAP_SENDER_FAULT	soap-sender-fault
SORT_MEMBERS_DIALOG	sort-members-dialog
SOURCE_PARSER	source-parser
SP	sp
SPECIAL_MANY2MANY_TREATMENT_FUNCTION_NAMES	special-many-2-many-treatment-function-names
SPECIFICATIONS	specifications
SPRING_CONTEXT_2_5_XSD_URI	spring-context-2-5-xsd-uri
SPRING_OSGI_XSD_ID	spring-osgi-xsd-id
SQLCADTA_SQLDTARD_RLO	sqlcadta-sqldtard-rlo
SQLDTARD	sqldtard
SQLTypes	sql-types
SQL_CONVERT_DECIMAL	sql-convert-decimal
SQL_CVT_BINARY	sql-cvt-binary
SQL_FILE_TABLE	sql-file-table
SQL_FN_NUM_ROUND	sql-fn-num-round
SQL_FN_TD_CURDATE	sql-fn-td-curdate
SQL_IDENTIFIER_CASE	sql-identifier-case
SQL_NC_HIGH	sql-nc-high
SQL_STRING_FUNCTIONS	sql-string-functions
SR	sr
SRE_ERROR_RECURSION_LIMIT	sre-error-recursion-limit
SRFI97Map	srfi97-map
SR_IGNORED_LESS_THAN	sr-ignored-less-than
SS	ss
SSL_OP_PKCS1_CHECK_1	ssl-op-pkcs1-check-1
SSL_OP_PKCS1_CHECK_2	ssl-op-pkcs1-check-2
ST	st
STANDARD_SERVICE_REF_NAME	standard-service-ref-name
STARTS_WITH_FILTER_NAME	starts-with-filter-name
START_EDITING	start-editing
START_ELEMENT_SIG	start-element-sig
START_HREF	start-href
START_PUNCTUATION	start-punctuation
STATE_LT_SLASH_H	state-lt-slash-h
STATE_PLAYING	state-playing
STATE_UNSUPPORTED	state-unsupported
STEP_LICENSE	step-license
STORE_CREATE_FINAL_METHOD_STUBS	store-create-final-method-stubs
STORE_DEREF	store-deref
STORE_SELECTED_CHEATSHEET_ID	store-selected-cheatsheet-id
STRING_JAVATYPE	string-javatype
STRING_LITERAL_COMPARATOR	string-literal-comparator
STRUCTURE_CREATOR_EXTENSION_POINT	structure-creator-extension-point
STRUCT_COLOR	struct-color
STRUTS_LOG_MISSING_PROPERTIES	struts-log-missing-properties
STRUTS_MAPPER_CLASS	struts-mapper-class
STUB_FOLDER_NAME	stub-folder-name
STYLE_NONE	style-none
ST_CANCELLED	st-cancelled
ST_DISABLED	st-disabled
ST_ERR_REC_NOT_FOUND	st-err-rec-not-found
ST_NODE_REGISTRATION_STATUS	st-node-registration-status
ST_TRACKER_READ_BYTES	st-tracker-read-bytes
SUBID_BT_BITFIELD	subid-bt-bitfield
SUBID_BT_KEEP_ALIVE	subid-bt-keep-alive
SUB_EDIT_MODE_KEY	sub-edit-mode-key
SUB_TEXT_FONT	sub-text-font
SUCCESS_COMMAND	success-command
SUITES	suites
SUN_EJBJAR_210beta_DTD_SYSTEM_ID	sun-ejb-jar-210beta-dtd-system-id
SV	sv
SVRCOD_ACCDMG	svrcod-accdmg
SW	sw
SWA_URI	swa-uri
SWITCH_TO_BRANCH_POPUP_ITEM	switch-to-branch-popup-item
SWITCH_TO_LAUNCH_BAR	switch-to-launch-bar
SW_MINIMIZE	sw-minimize
SX	sx
SY	sy
SYNERRCD_DSS_CONT_LESS_OR_EQUAL_2	synerrcd-dss-cont-less-or-equal-2
SYSCONGLOMERATES_INDEX1_ID	sys-conglomerates-index1-id
SYSSTATISTICS_COLCOUNT	sys-statistics-col-count
SYSTEM_FAILURE	system-failure
SYSTEM_TEST	system-test
SYSTEM_WEB_APPLICATIONS	system-web-applications
S_API_ANALYSIS	s-api-analysis
S_CONNECT	s-connect
S_DIR_OPEN_SYMBOL	s-dir-open-symbol
S_FOR_PACKAGES	s-for-packages
S_OSGI_PROJECT	s-osgi-project
S_VENDORURL	s-vendor-url
S_XSL_OUTPUT_INDENT	s-xsl-output-indent
Sc	sc
SchedulerStartup_4PM	scheduler-startup-4pm
SchedulerStartup_5AM	scheduler-startup-5am
SchedulerStartup_5PM	scheduler-startup-5pm
SchedulerStartup_6AM	scheduler-startup-6am
SchedulerStartup_6PM	scheduler-startup-6pm
SchedulerStartup_7AM	scheduler-startup-7am
SchedulerStartup_7PM	scheduler-startup-7pm
SchedulerStartup_8AM	scheduler-startup-8am
SchedulerStartup_8PM	scheduler-startup-8pm
SchedulerStartup_9AM	scheduler-startup-9am
SchedulerStartup_9PM	scheduler-startup-9pm
SchemaAttributeDetails_browseButton	schema-attribute-details-browse-button
Se	se
SearchLabelProvider_potential_singular	search-label-provider-potential-singular
SearchPageSelectionDialog_title	search-page-selection-dialog-title
Search_FindReadReferencesInWorkingSetAction_tooltip	search-find-read-references-in-working-set-action-tooltip
SelfEncapsulateFieldInputPage_default	self-encapsulate-field-input-page-default
SharedIntroConfigurer_customize_label	shared-intro-configurer-customize-label
ShiftLeftEqual	shift-left-equal
ShowRefactoringHistoryControl_delete_all_label	show-refactoring-history-control-delete-all-label
SiteEditor_IncludedFeaturesDetailsSection_featureLabel	site-editor-included-features-details-section-feature-label
Sk	sk
Sm	sm
So	so
SocketAttachingConnectorImpl_Connection_argument_is_not_of_the_right_type_6	socket-attaching-connector-impl-connection-argument-is-not-of-the-right-type-6
SourceAttachmentBlock_filename_external_varbutton	source-attachment-block-filename-external-varbutton
SourceAttachmentForm_message_noSource	source-attachment-form-message-no-source
SourceContainerType_0	source-container-type-0
SouthEastGravity	south-east-gravity
Ss	ss
StackTraceSupportArea_NoStackTrace	stack-trace-support-area-no-stack-trace
SuspendTimeoutHandler_timeout_occurred	suspend-timeout-handler-timeout-occurred
SyncInfoCompareInput_localLabelAuthorExists	sync-info-compare-input-local-label-author-exists
SyncInfoCompareInput_remoteLabelAuthorExists	sync-info-compare-input-remote-label-author-exists
T	t
T0	t-0
T1	t-1
T2	t-2
TABLE_MYTORRENTS_INCOMPLETE_BIG	table-my-torrents-incomplete-big
TAB_COLOR	tab-color
TAB_SET	tab-set
TAG_ACTION_BAR_ADVISOR	tag-action-bar-advisor
TAG_HEAD_LINK	tag-head-link
TAG_IMAGE	tag-image
TAG_OPEN_ID	tag-open-id
TAG_PRIORITY_FILTER	tag-priority-filter
TAG_TYPES	tag-types
TARGET_ZIP_LOGS	target-zip-logs
TASK_BASELINE6_DURATION	task-baseline6-duration
TASK_CLASS_TEMPLATE	task-class-template
TASK_DURATION5_UNITS	task-duration5-units
TASK_ENTERPRISE_DATE13	task-enterprise-date-13
TASK_ENTERPRISE_DATE14	task-enterprise-date-14
TASK_ENTERPRISE_DATE15	task-enterprise-date-15
TASK_ENTERPRISE_DATE16	task-enterprise-date-16
TASK_ENTERPRISE_DATE17	task-enterprise-date-17
TASK_ENTERPRISE_DATE18	task-enterprise-date-18
TASK_ENTERPRISE_DATE19	task-enterprise-date-19
TASK_NOTES_RECORD_NUMBER	task-notes-record-number
TASK_XML_EMBED	task-xml-embed
TB	tb
TCP_NS_PREFIX	tcp-ns-prefix
TC_LIMIT	tc-limit
TD	td
TD_LEFT	td-left
TEMPLATES_KEY	templates-key
TEST_NAT_PROXIES	test-nat-proxies
TEST_N_B	test-n-b
TEST_RUN	test-run
TEST_URI	test-uri
TEXT_DISPLAY_NAME	text-display-name
TEXT_PLAIN_BASE_TYPE	text-plain-base-type
TEXT_TEXT	text-text
TH	th
THEME_REQUEST_ATTRIBUTE_NAME	theme-request-attribute-name
THREAD_GROUP_HAS_ACTIVE_THREADS_IN_CLOSE	thread-group-has-active-threads-in-close
THROWN_PREFIX	thrown-prefix
TIMESTAMPS_FILE_PREFIX	timestamps-file-prefix
TIMESTAMPS_LOCK	timestamps-lock
TL	tl
TLIB_VERSION	tlib-version
TL_MEMBER_START	tl-member-start
TM	tm
TMP_API_FILE_POSTFIX	tmp-api-file-postfix
TMS_VCLV	tms-vclv
TO	to
TOBOTTOM_TOLEFT	to-bottom-to-left
TOKEN_TYPE_LOWER_PREC	token-type-lower-prec
TOOLBAR_NAVIGATE	toolbar-navigate
TOOLS_OPTIONS_CND_HIGHLIGHTING_ID	tools-options-cnd-highlighting-id
TOOL_WSGEN	tool-wsgen
TOO_MANY_BYTES	too-many-bytes
TOP_LEVEL_TERMS	top-level-terms
TOTAL_REV	total-rev
TPFLAGS_BASETYPE	tpflags-basetype
TR	tr
TRACE_BUILDERS	trace-builders
TRACE_LEVEL_KEY	trace-level-key
TRAVERSE_RETURN	traverse-return
TREE_SET_CLASSNAME	tree-set-classname
TRIGGER_FULL	trigger-full
TRUE_VALUE	true-value
TRUST_NS_URI	trust-ns-uri
TSF_NEWLINES	tsf-newlines
TT	tt
TV_FALSE_VALUE	tv-false-value
TWIDDLE	twiddle
TWO_PWR_16_DBL	two-pwr-16-dbl
TWO_WAY	two-way
TXT_X_PAD	txt-x-pad
TYPEPARAMETERS	type-parameters
TYPE_DELIMITER	type-delimiter
TYPE_INDEX	type-index
TYPE_MAIL_RESOUCE	type-mail-resouce
TYPE_NMTOKEN	type-nmtoken
TYPE_OFFSET	type-offset
TYPE_UPDATE_SIMILAR_ELEMENTS	type-update-similar-elements
T_BOOL_CAST	t-bool-cast
T_COMMENT_AS_STRING	t-comment-as-string
T_JavaLangAnnotationDocumented	t-java-lang-annotation-documented
T_LNUMBER	t-lnumber
T_LONG_EXTRA	t-long-extra
T_REQUIRE	t-require
TaskList_line	task-list-line
TemplatesPage_remove_message_multi	templates-page-remove-message-multi
TextEditorDefaultsPreferencePage_enrichHover_disabled	text-editor-defaults-preference-page-enrich-hover-disabled
TextMergeViewer_accessible_left	text-merge-viewer-accessible-left
TocDetails_dialogMessage	toc-details-dialog-message
TocDetails_nameText	toc-details-name-text
TocLinkDetails_title	toc-link-details-title
TodoTaskConfigurationBlock_markers_tasks_normal_priority	todo-task-configuration-block-markers-tasks-normal-priority
TodoTaskInputDialog_priority_high	todo-task-input-dialog-priority-high
TokenNameMULTIPLY	token-name-multiply
TrimCommon_Bottom	trim-common-bottom
TypeFilterInputDialog_error_enterName	type-filter-input-dialog-error-enter-name
TypeHierarchyViewPart_createinput	type-hierarchy-view-part-create-input
TypeType	type-type
U	u
UBERSPECT_CLASSNAME	uberspect-classname
UCS_MARKTODO	ucs-marktodo
UDT_TYPE	udt-type
UE	ue
UH	uh
UI	ui
UK	uk
UL	ul
UNABLE_TO_COPY_DATA_DIRECTORY	unable-to-copy-data-directory
UNBOUNDED_BUFFER	unbounded-buffer
UNCHECKED	unchecked
UNDEFINED_ID	undefined-id
UNEDITABLE	uneditable
UNICODE_CHAR	unicode-char
UNIQUEDESC	unique-desc
UNRELATED_PREFIX_MSG_KEY	unrelated-prefix-msg-key
UP	up
UPDATE_CARET	update-caret
UPDATE_SCOPE_CURRENT_POM	update-scope-current-pom
UPPER_SOURCE	upper-source
URI_ENVELOPE12	uri-envelope-12
URL_INVALID_BUNDLE_ID	url-invalid-bundle-id
URL_PROP	url-prop
URL_PROTOCOL_JAR	url-protocol-jar
US	us
USER_HOME	user-home
USE_OWN_CARET_POSITION	use-own-caret-position
USING	using
UTF_32_ENC	utf-32-enc
UTIL_CONCURRRENT_SIG_PREFIX	util-concurrrent-sig-prefix
UU	uu
UndefinedField	undefined-field
UnnecessaryCast	unnecessary-cast
UnresolvedElementsSubProcessor_swaparguments_description	unresolved-elements-sub-processor-swap-arguments-description
UnusedCodeMultiFix_RemoveUnusedImport_description	unused-code-multi-fix-remove-unused-import-description
UseReportConverter_scan_date	use-report-converter-scan-date
UserLibraryPreferencePage_browsejar_edit_title	user-library-preference-page-browse-jar-edit-title
V	v
V1	v-1
V2	v-2
V3	v-3
VALID_NAME_PATTERN	valid-name-pattern
VALUE_ATTRIBUTE	value-attribute
VALUE_BUTTON	value-button
VALUE_PASSWORD	value-password
VARBINARY	var-binary
VARIABLES_DETAIL_PANE_AUTO	variables-detail-pane-auto
VARIABLE_PUBLIC_ICON	variable-public-icon
VC	vc
VERIFY_AUTHORITY	verify-authority
VERSION_QNAME	version-qname
VERTICAL_ALIGN_TEXT_BOTTOM	vertical-align-text-bottom
VERTICAL_SELECTION_MODE	vertical-selection-mode
VERY_DARK_CYAN	very-dark-cyan
VI	vi
VIEWS_SHOW_IN	views-show-in
VIEW_ATTRIBUTE	view-attribute
VIEW_PARENTFOLDER	view-parentfolder
VIOLET	violet
VK_LSHIFT	vk-lshift
VK_SLASH	vk-slash
VM	vm
VMD_PROPERTIES_NAME	vmd-properties-name
VT	vt
VUZE_HOST_CORE	vuze-host-core
VirtualMachineImpl_Add_method_not_implemented_1	virtual-machine-impl-add-method-not-implemented-1
Vx	vx
Vy	vy
W	w
WAVE_FORMAT_UNKNOWN	wave-format-unknown
WAVE_IBM_FORMAT_ADPCM	wave-ibm-format-adpcm
WC_PROPS_ATTR	wc-props-attr
WD	wd
WEAVEMESSAGE_DECLAREPARENTSEXTENDS	weave-message-declare-parents-extends
WEB_MODULE	web-module
WEB_MODULE_HAS_SECURITY_REALM	web-module-has-security-realm
WG	wg
WHOLE_REGION	whole-region
WI	wi
WIREADMIN_PID	wire-admin-pid
WIZARD_NOT_VALID_CERT	wizard-not-valid-cert
WJ	wj
WM_COMMAND	wm-command
WO	wo
WORKBENCH_VISIBLE_VIEW_ID	workbench-visible-view-id
WORKSPACE_API_BASELINE_ID	workspace-api-baseline-id
WRONG_PASSWORD_CHANGE_FORMAT	wrong-password-change-format
WRONG_TYPE	wrong-type
WS	ws
WSDLPORTID	wsdl-port-id
WSDL_FROM_SERVICE	wsdl-from-service
WSIPMORT_GENERATE_PREFIX	wsipmort-generate-prefix
WU	wu
WWW_ACTIVATE	www-activate
Wb	wb
WhiteSpaceOptions_type_arguments	white-space-options-type-arguments
WhiteSpaceTabPage_calls_after_comma_in_alloc	white-space-tab-page-calls-after-comma-in-alloc
WindowTitle	window-title
WizardPreferencesExportPage1_exportTitle	wizard-preferences-export-page1-export-title
WorkbenchPage_unableToSavePerspective	workbench-page-unable-to-save-perspective
Workbench_goInto	workbench-go-into
Workbench_rename	workbench-rename
WorkingSetContent	working-set-content
X	x
X0	x-0
XAMGR	xamgr
XAMPP	xampp
XA_MANAGER	xa-manager
XA_RBTIMEOUT	xa-rbtimeout
XA_T0_NOT_ASSOCIATED	xa-t0-not-associated
XK_Arabic_fathatan	xk-arabic-fathatan
XK_Greek_ALPHAaccent	xk-greek-alpha-accent
XK_Hangul_J_RieulMieum	xk-hangul-j-rieul-mieum
XK_Help	xk-help
XK_Thai_maiek	xk-thai-maiek
XK_Umacron	xk-umacron
XK_Undo	xk-undo
XK_integral	xk-integral
XK_lcaron	xk-lcaron
XMLSPACE_STRING	xmlspace-string
XMLTYPE	xml-type
XML_DATA	xml-data
XML_DECL	xml-decl
XML_EXCEPTION_STACKTRACE_ELEMENT	xml-exception-stacktrace-element
XML_NAMESPACE_MAGIC	xml-namespace-magic
XML_SPACE	xml-space
XP	xp
XPATH_SCHEMA_REDEFINE_LOCATION	xpath-schema-redefine-location
XPTRTOKEN_SHORTHAND	xptr-token-shorthand
XSD_TYPE	xsd-type
XSL_RESOURCE	xsl-resource
XV	xv
X_ChangeGC	x-change-gc
X_CopyGC	x-copy-gc
X_ListExtensions	x-list-extensions
XmMAX_SHORT	xm-max-short
Y	y
Y0	y-0
Y1	y-1
Y2	y-2
Y3	y-3
Y4	y-4
YI	yi
YUILOADER	yui-loader
YYFINAL	yy-final
Z	z
ZERO_DOWNLOAD_SETTING	zero-download-setting
ZIPPY_PULSE_TIME	zippy-pulse-time
ZipExport_alreadyExistsError	zip-export-already-exists-error
Zl	zl
Zp	zp
Zs	zs
_ATTR_READONLY	attr-readonly
_ATT_ENCODING	att-encoding
__GetProperties	get-properties
__bases__	bases
__doc__system	doc-system
__extend_property_2_values	extend-property-2-values
_a	a
_algorithmHash	algorithm-hash
_annoToUnit	anno-to-unit
_appLimit	app-limit
_appid	app-id
_b	b
_bodies	bodies
_c	c
_cachedHeapSize	cached-heap-size
_chosenMethod	chosen-method
_contextDocument	context-document
_docOrder	doc-order
_documentation	documentation
_driverVersion	driver-version
_e	e
_emptyStringArray	empty-string-array
_f	f
_g	g
_i	i
_isSet_CheckUpToDate	is-set-check-up-to-date
_ixor	i-xor
_jdk14Levels	jdk14-levels
_kernelType	kernel-type
_lastChanged	last-changed
_lblSelectTheCategory	lbl-select-the-category
_lblTestPackageFolders	lbl-test-package-folders
_letterValue	letter-value
_loadOptions	load-options
_locale	locale
_lreturn	l-return
_memberAccess	member-access
_nonEscapingElements	non-escaping-elements
_nonIdentifyingStringOnThirdBitCES	non-identifying-string-on-third-bit-ces
_property_value_pattern	property-value-pattern
_ready	ready
_realm	realm
_referencedColumn	referenced-column
_resourceBundle	resource-bundle
_returnVersionId	return-version-id
_runInBatchMode	run-in-batch-mode
_s	s
_selectedWeekDays	selected-week-days
_sessionIds	session-ids
_testCmdLine	test-cmd-line
_thread	thread
_tk_ushort	tk-ushort
_txtArguments	txt-arguments
_useLocalNameAsKeyForQualifiedNameLookup	use-local-name-as-key-for-qualified-name-lookup
_v	v
_w	w
_x	x
_xmlList	xml-list
_xmlStAXEventWriter	xml-stax-event-writer
_y	y
a	a
a1	a-1
a2	a-2
a3	a-3
a4	a-4
a9	a-9
aPaddingType	a-padding-type
aZ	a-z
aa	aa
ab	ab
abortLock	abort-lock
aborting	aborting
ac	ac
acceptUnsignedFiles	accept-unsigned-files
accessible_hypertext_nlinks	accessible-hypertext-nlinks
accumulate	accumulate
acknowledgedXmimeContentTypes	acknowledged-xmime-content-types
actionBeanContext	action-bean-context
actionMAbstraction	action-m-abstraction
actionTable	action-table
actionWebBrowserGo	action-web-browser-go
actionsChain	actions-chain
actionsList	actions-list
activation_count_time	activation-count-time
activePartIndex	active-part-index
activeWorkbenchWindow	active-workbench-window
actualTypeArgs	actual-type-args
ad	ad
adapterId	adapter-id
addDistinctAggregateColumnNum	add-distinct-aggregate-column-num
addURLButton	add-url-button
additionalArgs	additional-args
addr_bit	addr-bit
addressSize	address-size
adminId	admin-id
adminPortValue	admin-port-value
af	af
ag	ag
agentServices	agent-services
agressive	agressive
ah	ah
ai	ai
al	al
allColumnNames	all-column-names
allTestSourceGroups	all-test-source-groups
allocSize	alloc-size
allowEnums	allow-enums
allowedStates	allowed-states
alphaBits	alpha-bits
alternateAddTag	alternate-add-tag
alwaysOnTop	always-on-top
am	am
analyze	analyze
anchorSelectionIndex	anchor-selection-index
annoHelpers	anno-helpers
ap	ap
appenderTable	appender-table
appletlauncher_utils_error_main_type_not_specified	applet-launcher-utils-error-main-type-not-specified
appointmentPanel	appointment-panel
ar	ar
areaProvidersLookupResult	area-providers-lookup-result
argsFile	args-file
argslist	args-list
artifactClassLoader	artifact-class-loader
artifact_not_directory	artifact-not-directory
as	as
asText	as-text
as_is_payload	as-is-payload
associatedInstallURL	associated-install-url
astoffset	ast-offset
at	at
attlistDecl	att-list-decl
attrChange	attr-change
attrMap	attr-map
attrSet	attr-set
attrUID	attr-uid
attrURI	attr-uri
attributeTable	attributetable
au	au
auditCfg	audit-cfg
authCacheFlushThread	auth-cache-flush-thread
authPrivMask	auth-priv-mask
autoAddNewResourcesAndTasks	auto-add-new-resources-and-tasks
autoDropSchema	auto-drop-schema
autoProxyScript	auto-proxy-script
autoRefreshButton	auto-refresh-button
autoUpdateSchema	auto-update-schema
autoWaitCursor	auto-wait-cursor
autosaveFile	auto-save-file
autowiredAnnotationTypes	auto-wired-annotation-types
av	av
availabilitySpreadsheet	availability-spreadsheet
availabilityTable	availability-table
availableRows	available-rows
aw	aw
axesAtLeft	axes-at-left
az	az
b	b
b0	b-0
b1	b-1
b2	b-2
b3	b-3
b4	b-4
bA	ba
bIconMoved	b-icon-moved
ba	ba
backColor	back-color
backgroundSaveListeners	background-save-listeners
backing_iterators	backing-iterators
base64	base64
base64Alphabet	base64-alphabet
baseArgumentCount	base-argument-count
baseCC	base-cc
baseCD	base-cd
baseClassName	base-class-name
baseDirStack	base-dir-stack
baseFO	base-fo
baseFontSize	base-font-size
baseHi	base-hi
baseId	base-id
baseItemLabelPaint	base-item-label-paint
baseLegendTextPaint	base-legend-text-paint
base_cc	base-cc
base_table_static_info	base-table-static-info
basedOn	based-on
baselineWorkTypes	baseline-work-types
basicChecker	basic-checker
bb	bb
bc	bc
bc_aload_0	bc-aload-0
bc_aload_1	bc-aload-1
bc_aload_2	bc-aload-2
bc_aload_3	bc-aload-3
bc_case_count	bc-case-count
bc_fmul	bc-fmul
bc_fneg	bc-fneg
bd	bd
bdConvertibleTypes	bd-convertible-types
beforeUnmarshal	before-unmarshal
beginStackSize	begin-stack-size
bf	bf
bg	bg
bgmBuilder	bgm-builder
bh	bh
bi	bi
binding	binding
bindingsIBMD	bindings-ibmd
bl	bl
blockerLock	blocker-lock
boldfont	bold-font
bookmarksUndoContext	bookmarks-undo-context
bp	bp
br	br
breakpointListeners	breakpoint-listeners
brokenProjectBadge	broken-project-badge
browseFileTransferProtocolMap	browse-file-transfer-protocol-map
browserAdapter	browser-adapter
bs	bs
bscan	b-scan
bt	bt
btCMakeBrowse	bt-c-make-browse
btn_ucs_holiday	btn-ucs-holiday
bufferLimitField	buffer-limit-field
bufferManagerRead	buffer-manager-read
bufferPool	buffer-pool
buttonsToolBar	buttons-tool-bar
bv	bv
bw	bw
bx	bx
by	by
bytesUsed	bytes-used
c	c
c0	c-0
c1	c-1
c2	c-2
c2tnb431r1	c2-tnb431-r1
c3	c-3
cA	ca
cAlignActionB	c-align-action-b
cArea	c-area
cMainProject	c-main-project
cRLIssuer	c-rl-issuer
cText	c-text
c_lflag	c-lflag
ca	ca
cacheConfigPath	cache-config-path
cacheHeight	cache-height
cacheListener	cache-listener
cacheObjectMaxSize	cache-object-max-size
cacheYear	cache-year
cache_1_dataFileIsActive	cache-1-data-file-is-active
cachedEntityKey	cached-entity-key
cachedRowMin	cached-row-min
canBeVoid	can-be-void
captureStackTrace	capture-stack-trace
cascadeStyles	cascade-styles
categoryBox	category-box
categoryParameterName	category-parameter-name
cb	cb
cc	cc
ccsa25Text	ccsa25-text
cd	cd
ce	ce
cellTipComponent	cell-tip-component
certPathLen	cert-path-len
certSubject	cert-subject
cf	cf
cfolder	c-folder
cg	cg
ch	ch
change2Refs	change-2-refs
changePushPathButton	change-push-path-button
changedData	changed-data
changingCount	changing-count
characterIteratorTarget	character-iterator-target
chartHeight	chart-height
checkProgress	check-progress
checkcount	check-count
childOfsSize	child-ofs-size
ci	ci
cl	cl
classNameProvider	class-name-provider
classPathRadio	class-path-radio
classPersisterClass	class-persister-class
classPrefixes	class-prefixes
classToInfo	class-to-info
class_Signature_RS	class-signature-rs
classpath_illegalContainerPath	classpath-illegal-container-path
clazzRef	clazz-ref
cleanCommand	clean-command
clientCertRB	client-cert-rb
clipData	clip-data
clockIcon	clock-icon
cloneQueryButton	clone-query-button
close_web_view	close-web-view
clsAccum	cls-accum
cm	cm
cmToConnectionsMap	cm-to-connections-map
cmodule	c-module
cn	cn
codeNameBase	code-name-base
codeSnippet	code-snippet
codeTemplatesPanel	code-templates-panel
codebasePolicy	codebase-policy
colMappings	col-mappings
collected	collected
collectionCreations	collection-creations
collector	collector
colnames	col-names
columnAlias	column-alias
columnElement	column-element
combine	combine
comboBoxLanguages	combo-box-languages
commandColorEditor	command-color-editor
commandLineArgArray	command-line-arg-array
comment_format_header	comment-format-header
commitOnEdit	commit-on-edit
commonWizardDescriptors	common-wizard-descriptors
compileMode	compile-mode
compileOnSaveDisabled	compile-on-save-disabled
compileTimeConstants	compile-time-constants
compiledExclusionPatterns	compiled-exclusion-patterns
compilerData	compiler-data
complete_disabled	complete-disabled
completionEventProcessed	completion-event-processed
completionGroup	completion-group
complex___float___doc	complex-float-doc
componentListenerK	component-listenerk
componentListeners	component-listeners
componentSizeIncrement	component-size-increment
comptype	comp-type
concurrentExecutor	concurrent-executor
conditionResult	condition-result
confDescriptor	conf-descriptor
configAndLibrariesListener	config-and-libraries-listener
configErrMsg	config-err-msg
configurationDataTransformer	configuration-data-transformer
conglomerate_OneRowResultSet	conglomerate-one-row-result-set
conjunction	conjunction
connectionMonitor	connection-monitor
connectionPanel	connection-panel
considerTimingInformation	consider-timing-information
contactedProtocolComboBox	contacted-protocol-combo-box
containerElem	container-elem
containerProviders	container-providers
containingComponents	containing-components
contentExtensions	contentext-ensions
contentMargins	content-margins
content_badInitializationData	content-bad-initialization-data
content_list	content-list
controlPermission	control-permission
controller	controller
conversionHelper	conversion-helper
corbaConnection	corba-connection
coreFontNameIDs	core-font-name-ids
could_not_remove_initialProfile	could-not-remove-initial-profile
counterGuard	counter-guard
countryName	country-name
cp	cp
cr	cr
crNoOutgoingTransitions	cr-no-outgoing-transitions
crSingletonViolatedOPC	cr-singleton-violated-opc
createMapMethod	create-map-method
createProductionDb	create-production-db
createSearchTabItem	create-search-tab-item
createTCTime	create-tc-time
createThread	create-thread
createdScanExecutor	created-scan-executor
criteriaManager	criteria-manager
criterionData	criterion-data
crossMenuMnemonic	cross-menu-mnemonic
cryptokiVersion	crypto-ki-version
cs	cs
cssMethods	css-methods
ct	ct
ctors	ctors
ctrlisModifier	ctrlis-modifier
cu	cu
curFileExt	cur-file-ext
curGramSize	cur-gram-size
currentCompilerSet	current-compiler-set
currentCount	current-count
currentDumpTimeStamp	current-dump-time-stamp
currentIndentation	current-indentation
currentLineHighlight	current-line-highlight
currentModifiers	current-modifiers
currentPosInPrevOpcodeBuffer	current-pos-in-prev-opcode-buffer
currentReaderGen	current-reader-gen
currentSprint	current-sprint
currentStaleListener	current-stale-listener
customButton	custom-button
customFont	custom-font
customRangeStart	custom-range-start
customSQLDelete	custom-sql-delete
customWrite	custom-write
customizerBundle	customizer-bundle
customizerExtenders	customizer-extenders
cv	cv
cw	cw
cx	cx
cy	cy
cycleTime	cycle-time
d	d
d2	d-2
dL	d-l
dP	d-p
dQ	d-q
dX	d-x
da	da
damageEndPos	damage-end-pos
dataArea	data-area
dataSourceToUse	data-source-to-use
dayCheckBoxHandler	day-check-box-handler
db	db
dbDirName	db-dir-name
dbconn	db-conn
dc	dc
dd	dd
ddCallBack	dd-call-back
de	de
deactivatedEditorPercentages	deactivated-editor-percentages
deadOrDying	dead-or-dying
debugPortModelFlag	debug-port-model-flag
decider	decider
decisionNFAStartState	decision-nfa-start-state
declarations	declarations
declaringTypeModifiers	declaring-type-modifiers
declaringTypeName	declaring-type-name
decorationPosition	decoration-position
defSerializable	def-serializable
defaultCodeFoldingCollapseInnerClass	default-code-folding-collapse-inner-class
defaultCommandMap	default-command-map
defaultDataEnd	default-data-end
defaultEncodingSupported	default-encoding-supported
defaultGroupListeners	default-group-listeners
defaultImageCaps	default-image-caps
defaultInputMethodsEnabled	default-input-methods-enabled
defaultJavaFormatLeadingSpaceInComment	default-java-format-leading-space-in-comment
defaultLanguageChoosen	default-language-choosen
defaultNetworkConnectorName	default-network-connector-name
defaultOpen	default-open
defaultStatement	default-statement
defaultTemplateType	default-template-type
defaultUseCaches	default-use-caches
default_architecture	default-architecture
defaultsButton	defaults-button
deferredIdentifierJob	deferred-identifier-job
delayedModalBlocking	delayed-modal-blocking
delayedRegistrationMap	delayed-registration-map
deletedDocsDirty	deleted-docs-dirty
delimiter_can_not_be_ignored	delimiter-can-not-be-ignored
demanglingService	demangling-service
dependants	dependants
deploymentBuilder	deployment-builder
depsIndeces	deps-indeces
descImageCanvas	desc-image-canvas
descriptorsToWrite	descriptors-to-write
detailLabel	detail-label
detectFilesButton	detect-files-button
df	df
dg	dg
dh	dh
dialogLock	dialog-lock
diiRequest	dii-request
directionEstimator	direction-estimator
directoryList	directory-list
dirtyFlag	dirty-flag
disableEvents	disable-events
disableFiltering	disable-filtering
disableUpdateCheck	disable-update-check
disassembler_constantpool_interfacemethodref	disassembler-constant-pool-interface-method-ref
discardAllEdits	discard-all-edits
discoverySiteInfo	discovery-site-info
discoveryTimeList	discovery-time-list
displayablesComboBox	displayables-combo-box
displayedMoveNumber	displayed-move-number
dl	dl
dl_with_ref	dl-with-ref
dm	dm
dn	dn
doFortran	do-fortran
doOperation	do-operation
doSlider	do-slider
docBaseURI	doc-base-uri
docList	doc-list
docTypeRootElementName	doc-type-root-element-name
documentMarginColor	document-margin-color
domParser	dom-parser
dom_addSiblingBeforeRoot	dom-add-sibling-before-root
downButton	down-button
downloadConfigurationLogicAction	download-configuration-logic-action
dp	dp
dq	dq
dr	dr
dragDetect	drag-detect
dragStarted	drag-started
drawButtonPanel	draw-button-panel
drawFlags	draw-flags
drawGlyphListLCDLoop	draw-glyph-list-lcd-loop
drawMethod	draw-method
drawingSupplier	drawing-supplier
driverNotFound	driver-not-found
dropLocation	drop-location
ds	ds
dt	dt
dtdCache	dtd-cache
dtree_reverse	dtree-reverse
dueDate	due-date
dummyPage	dummy-page
dvFactory	dv-factory
dw	dw
dx	dx
dy	dy
e	e
e1	e-1
e2	e-2
e3	e-3
e_	e
ea	ea
ec	ec
ed	ed
editControl	edit-control
editDepButton	edit-dep-button
editingIcon	editing-icon
editorActionsMap	editor-actions-map
editorContext	editor-context
ee	ee
ef	ef
eh	eh
ei	ei
ejbVersion	ejb-version
ek	ek
el	el
elementSetFactory	element-set-factory
em	em
en	en
enableDirectoryDeployment	enable-directory-deployment
enableGnowsisSupport	enable-gnowsis-support
endBounds	end-bounds
endPageIndex	end-page-index
entryVector	entry-vector
enumerate___iter___doc	enumerate-iter-doc
enumeratedType	enumerated-type
ep	ep
eq	eq
equalsMth	equals-mth
equalsStr	equals-str
er	er
errSymbol	err-symbol
errorOnUseBeanInvalidClassAttribute	error-on-use-bean-invalid-class-attribute
errorReportValveObjectName	error-report-valve-object-name
es	es
escapeActionListener	escape-action-listener
escapeTable	escape-table
establishMsg	establish-msg
eu	eu
ev	ev
evalCallback	eval-callback
evalResult	eval-result
ew	ew
ex	ex
execAction	exec-action
executors	executors
expButton	exp-button
expContent	exp-content
expandAllFoldsAction	expand-all-folds-action
expandTabToSpaces	expand-tab-to-spaces
expectedClasses	expected-classes
expectedTokenSequences	expected-token-sequences
explicitOutputSOAPBodyParts	explicit-output-soap-body-parts
explicitVersionInsertion	explicit-version-insertion
explicit_gzip	explicit-gzip
externSystemField	extern-system-field
externalDiff	external-diff
externallyManagedDestroyMethods	externally-managed-destroy-methods
extraContext	extra-context
extraLicenseFiles	extra-license-files
extraTypes	extra-types
f	f
f0	f-0
f1	f-1
f1Dialog	f1-dialog
f2	f-2
f3	f-3
f4	f-4
f5	f-5
f8	f-8
fAccessorChoices	f-accessor-choices
fAddDefault	f-add-default
fAddWorkspaceButton	f-add-workspace-button
fAllocationExpressionArgumentsCategory	f-allocation-expression-arguments-category
fAllowPluginLoading	f-allow-plugin-loading
fAnySimpleType	f-any-simple-type
fApiDescription	f-api-description
fArchiveCombo	f-archive-combo
fArrayTypes	f-array-types
fAutoIndentStrategies	f-auto-indent-strategies
fBackAction	f-back-action
fBaseTypeName	f-base-type-name
fBestMatch	f-best-match
fBootstrap	f-bootstrap
fCaretOffset	f-caret-offset
fCategorySection	f-category-section
fCharacterPairMatcher	f-character-pair-matcher
fCheckbox	f-checkbox
fClipboard	f-clipboard
fCodePositions	f-code-positions
fCompilerSun	f-compiler-sun
fConditionEnabled	f-condition-enabled
fContainers	f-containers
fContentAssistSubjectControlShell	f-content-assist-subject-control-shell
fCountIndication	f-count-indication
fCurrentDVFactory	f-current-dv-factory
fCurrentPreviewViewer	f-current-preview-viewer
fCustomBuilderSettings	f-custom-builder-settings
fDataCheatSheetID	f-data-cheat-sheet-id
fDateString	f-date-string
fDelegateHandler	f-delegate-handler
fDirectories	f-directories
fDoCreateComments	f-do-create-comments
fDoLoopReentrance	f-do-loop-reentrance
fDocumentTypeIndex	f-document-type-index
fEOFHandler	f-eof-handler
fElementToNewName	f-element-to-new-name
fEnabledButton	f-enabled-button
fEnabledTarget	f-enabled-target
fEntitySystemId	f-entity-system-id
fEntryFilter	f-entry-filter
fEnumerationTypeList	f-enumeration-type-list
fEventHandlers	f-event-handlers
fEventSocket	f-event-socket
fExceptionOccurrencesAction	f-exception-occurrences-action
fExpressions	f-expressions
fFilter	f-filter
fFinalMatch	f-final-match
fFinalSet	f-final-set
fFindDeclarationsAction	f-find-declarations-action
fFloatType	f-float-type
fFocusOnTypeAction	f-focus-on-type-action
fForceOutOfSync	f-force-out-of-sync
fGrouping	f-grouping
fHVSashCursor	f-hv-sash-cursor
fHasUninstalledComputers	f-has-uninstalled-computers
fImplements	f-implements
fInitialReconcile	f-initial-reconcile
fIsAssignmentOperator	f-is-assignment-operator
fIsBuiltIn	f-is-built-in
fIsDeepFiltering	f-is-deep-filtering
fJarsPage	f-jars-page
fJavaTextTools	f-java-text-tools
fLaunchConfigButton	f-launch-config-button
fLaunchConfigurationName	f-launch-configuration-name
fLinkingEnabled	f-linking-enabled
fLoadExternalDTD	f-load-external-dtd
fLocation	f-location
fLowestValidCodeIndex	f-lowest-valid-code-index
fMainTypeName	f-main-type-name
fManifestFileLabel	f-manifest-file-label
fMatcherStack	f-matcher-stack
fMemberBindings	f-member-bindings
fMessageFormatters	f-message-formatters
fMessageOutputLevel	f-message-output-level
fModelGroupIndex	f-model-group-index
fMouseTracker	f-mouse-tracker
fMoveArguments	f-move-arguments
fNewVersion	f-new-version
fNoProfile	f-no-profile
fNotifierJob	f-notifier-job
fOrganizeImportsConfigLink	f-organize-imports-config-link
fOriginalAptEnabled	f-original-apt-enabled
fOuterPart	f-outer-part
fParamTypes	f-param-types
fParentEnvironment	f-parent-environment
fPerProjSettingsEnabled	f-per-proj-settings-enabled
fPluginElement	f-plugin-element
fPluginIdText	f-plugin-id-text
fPreferencePageAction	f-preference-page-action
fPreviewWidth	f-preview-width
fProjectNameField	f-project-name-field
fPropertiesListener	f-properties-listener
fPropertiesTable	f-properties-table
fProperty	f-property
fPropertyListeners	f-property-listeners
fQualifiedNameComponent	f-qualified-name-component
fQualifyReferencesWithDeclaringClassName	f-qualify-references-with-declaring-class-name
fRecursiveButton	f-recursive-button
fRefreshing	f-refreshing
fRememberContent	f-remember-content
fRemoveFavoritesButton	f-remove-favorites-button
fRenameProject	f-rename-project
fRequestsByTarget	f-requests-by-target
fResolutionForwarder	f-resolution-forwarder
fReturnTypeRange	f-return-type-range
fRuntimeProperties	f-runtime-properties
fScanner	f-scanner
fSearchJobRecord	f-search-job-record
fSelectedMB	f-selected-mb
fShowLibrariesNode	f-show-libraries-node
fSourceViewerConfiguration	f-source-viewer-configuration
fSpaceLimit	f-space-limit
fSubGroup	f-sub-group
fSynchronizedSymbolTable	f-synchronized-symbol-table
fTable	f-table
fTargetObject	f-target-object
fTestingMode	f-testing-mode
fTextParamList	f-text-param-list
fTextTools	f-text-tools
fTreeViewerComparator	f-tree-viewer-comparator
fTypeDescription	f-type-description
fUIPropertyChangeListener	f-ui-property-change-listener
fUseWorkspaceButton	f-use-workspace-button
fUserEntityResolver	f-user-entity-resolver
fViewerInputUpdateJob	f-viewer-input-update-job
fVisibilityModifier	f-visibility-modifier
fWaitLock	f-wait-lock
fWatchExpression	f-watch-expression
fWorkspaceButton	f-workspace-button
fX	fx
fY	fy
fa	fa
factoriesTracker	factories-tracker
factoryLoaded	factory-loaded
factoryResult	factory-result
failureDetector	failure-detector
fakeAttributes	fake-attributes
fallbackToDefaultTypeMatch	fallback-to-default-type-match
fastBoot	fast-boot
fast_unchoke_new_peers	fast-unchoke-new-peers
faultCodeElement	fault-code-element
fb	fb
fc	fc
fd	fd
fe	fe
feature_parse_emptyRequires	feature-parse-empty-requires
feedbackRenderer	feedback-renderer
ff	ff
fg	fg
fgDevPropertiesURL	fg-dev-properties-url
fgDocumentGetXmlVersionMethod	fg-document-get-xml-version-method
fgNativeEnv	fg-native-env
fh	fh
fi	fi
fieldComponents	field-components
fieldInfo	field-info
fieldSortDoTrackScores	field-sort-do-track-scores
fieldStartDelimiterIndex	field-start-delimiter-index
fieldsThatMightBeAProblem	fields-that-might-be-a-problem
fileBufferChangeListener	file-buffer-change-listener
fileEntry	file-entry
fileListeners	file-listeners
fileOrUrl	file-or-url
fileRWAccessSize	file-rw-access-size
fileStyles	file-styles
filesLabel	files-label
filterMode	filter-mode
filterParamsLabel	filter-params-label
filtersDialog_workingSetSelect	filters-dialog-working-set-select
filtersList	filters-list
findLabelBox	find-label-box
firstChildButton	first-child-button
firstDigit	first-digit
firstDraggedCell	first-dragged-cell
firstLinePC	first-line-pc
firstPageButton	first-page-button
firstRowPanel1	first-row-panel-1
firstRowPanel2	first-row-panel-2
firstRowPanel3	first-row-panel-3
fixedRange	fixed-range
fk	fk
fkeyCounter	f-key-counter
fl	fl
floatArray	float-array
floatValue	float-value
fm	fm
fn	fn
fo	fo
focusFillDarkC	focus-fill-dark-c
foldInnerClassesPreset	fold-inner-classes-preset
folderPref	folder-pref
footer	footer
forUpdateIndexScan	for-update-index-scan
forceNewParameters	force-new-parameters
forceSyncByMaster	force-sync-by-master
forcedSeeding	forced-seeding
foundTaskMessages	found-task-messages
fp	fp
fr	fr
frameMs	frame-ms
frameno	frame-no
frameworksListener	frameworks-listener
framing	framing
freeTaskIOs	free-task-ios
freeXML10DTDLoaderIndex	free-xml10-dtd-loader-index
freeXML10DTDValidatorIndex	free-xml10-dtd-validator-index
fs	fs
ft	ft
ftempCurrentElement	f-temp-current-element
fu	fu
fullDefinitions	full-definitions
fullyLoaded	fully-loaded
fv	fv
fw	fw
fx	fx
fy	fy
g	g
g0	g-0
g1	g-1
g2	g-2
g3	g-3
gb	gb
gb2312Decoder	gb2312-decoder
gc	gc
gd	gd
ge	ge
gemTool	gem-tool
generated	generated
generationsGraph	generations-graph
generator	generator
genericSortId	generic-sort-id
gensymindex	gen-sym-index
getIdentifierMethodClass	get-identifier-method-class
getMaxStatements__	get-max-statements
getRSF	get-rsf
get_text	get-text
gg	gg
ghostAlpha	ghost-alpha
giopDebugFlag	giop-debug-flag
gl	gl
glass	glass
globalAdditions	global-additions
globalNamespaceUID	global-namespace-uid
globalProfileManager	global-profile-manager
global_registered	global-registered
glyphsWidget	glyphs-widget
gm	gm
go	go
goodVersion	good-version
gp	gp
gr	gr
grammarClassLoader	grammar-class-loader
grandInclude	grand-include
grantEntries	grant-entries
grantable	grantable
granularities	granularities
graphLayout	graph-layout
graphManager	graph-manager
graphOutlineRect	graph-outline-rect
groupsNode	groups-node
gtk_entry_select_on_focus	gtk-entry-select-on-focus
gu	gu
guessing	guessing
gv	gv
gw	gw
gy	gy
h	h
h0	h-0
h1	h-1
h2	h-2
h3	h-3
h4	h-4
hMenu	h-menu
handlerControls	handler-controls
handlerFO	handler-fo
handlerId	handler-id
handlerPC	handler-pc
handlerPc	handler-pc
handler_1	handler-1
handlerpc	handler-pc
hasComputed	has-computed
hasPotentialMatches	has-potential-matches
hasResults	has-results
hasSVUID	has-svuid
hasTasksSelected	has-tasks-selected
hb	hb
hc	hc
hd	hd
headerTable	header-table
helloWorldTrigger	hello-world-trigger
hg	hg
hh	hh
hi	hi
hierarchy	hierarchy
higherCDtoStart	higher-cd-to-start
historyItems	history-items
historyModel	history-model
hm	hm
holdEvents	hold-events
homeBase	home-base
hookRegistry	hook-registry
horizontalGap	horizontal-gap
hostAdapterLocator	host-adapter-locator
hp	hp
hq	hq
hr	hr
hs	hs
ht	ht
httpServerName	http-server-name
hx	hx
hy	hy
i	i
i1	i-1
i2	i-2
i3	i-3
i4	i-4
iF	i-f
iListener	i-listener
ib	ib
ic	ic
icSigGrayData	ic-sig-gray-data
icSigSpace2CLR	ic-sig-space-2-clr
iconColor16	icon-color16
iconColor32	icon-color32
iconThemes	icon-themes
id	id
idColumn	id-column
idDeprecated	id-deprecated
idimpl	id-impl
ie	ie
ig	ig
ignoreCell	ignore-cell
ignoreMovedEvents	ignore-moved-events
ignoreStartChanged	ignore-start-changed
ignoredElementCount	ignored-element-count
ih	ih
ii	ii
il	il
im	im
imageTable	image-table
implCache	impl-cache
importIsWildcard	import-is-wildcard
importTableSorter	import-table-sorter
in	in
inDefaultEventSet	in-default-event-set
inFile	in-file
inNative	in-native
inNewProject	in-new-project
includedList	included-list
includedPackages	included-packages
includesList	includes-list
includesLock	includes-lock
includingChildren	including-children
incomingModificationListener	incoming-modification-listener
indentLoc	indent-loc
indentValue	indent-value
indexType	index-type
init_stopSearchOperator	init-stop-search-operator
initialResultLogConfig	initial-result-log-config
initialX	initial-x
initialY	initial-y
initializeAfterLoadMonitor	initialize-after-load-monitor
initializedFields	initialized-fields
initials	initials
initiatorId	initiator-id
injection	injection
inputFileListener	input-file-listener
inputProcessor	input-processor
inputReader	input-reader
inputStreamBridge	input-stream-bridge
inscopeNamespace	inscope-namespace
insertAllActiveImage	insert-all-active-image
insertCmd	insert-cmd
insertPosition	insert-position
insert_space_after_comma_in_superinterfaces	insert-space-after-comma-in-superinterfaces
insert_space_before_comma_in_array_initializer	insert-space-before-comma-in-array-initializer
insert_space_before_opening_brace_in_enum_constant	insert-space-before-opening-brace-in-enum-constant
insertedTextLength	inserted-text-length
insideRecovery	inside-recovery
installOtherSDRadioButton	install-other-sd-radio-button
installationFinished	installation-finished
instanceTypes	instance-types
instancemethod_im_self_doc	instance-method-im-self-doc
instrumentGettersSettersCheckbox	instrument-getters-setters-check-box
int___rsub___doc	int-rsub-doc
internalEditors	internal-editors
internal_static_com_google_gwt_dev_shell_remoteui_Message_Failure_fieldAccessorTable	internal-static-com-google-gwt-dev-shell-remoteui-message-failure-field-accessor-table
internal_static_com_google_gwt_dev_shell_remoteui_Message_Request_ViewerRequest_AddLog_descriptor	internal-static-com-google-gwt-dev-shell-remoteui-message-request-viewer-request-add-log-descriptor
interruptLock	interrupt-lock
io	io
ip	ip
ir	ir
is	is
isAffects	is-affects
isBitTypeId	is-bit-type-id
isBitmask	is-bit-mask
isCascadeDeleteEnabled	is-cascade-delete-enabled
isComposite	is-composite
isConstants	is-constants
isConstraint	is-constraint
isDirty	is-dirty
isEdit	is-edit
isEjbImplClass	is-ejb-impl-class
isFromPart	is-from-part
isFullMode	is-full-mode
isIgnorableReported	is-ignorable-reported
isInRelationService	is-in-relation-service
isJoining	is-joining
isLineEmpty	is-line-empty
isLocalTx	is-local-tx
isLookahead	is-look-ahead
isMainApplication	is-main-application
isMemoEdited	is-memo-edited
isMyProject	is-my-project
isNested	is-nested
isNonCyclic	is-non-cyclic
isReading	is-reading
isResizeInProgress	is-resize-in-progress
isRowSelected	is-rows-elected
isScript	is-script
isVersioned	is-versioned
isWindows7OrHigher	is-windows7-or-higher
isXWorkStarted	is-x-work-started
is_inbound_connection	is-inbound-connection
isconfigured	is-configured
it	it
italicActionB	italic-action-b
itemDetailsLabel	item-details-label
itsFields	its-fields
itsFunctionType	its-function-type
itsOrb	its-orb
itsStackTop	its-stack-top
iu	iu
iv	iv
iw	iw
ix	ix
iy	iy
j	j
j2	j-2
jButtonManager	j-button-manager
jCheckBoxPrivate	j-check-box-private
jLabelEmbeddedCP	j-label-embedded-cp
jOKButton	j-ok-button
jPanelButtonFrame	j-panel-button-frame
jPanelJars	j-panel-jars
jTxtJndiName	j-txt-jndi-name
jTxtWsdlPublishLocation	j-txt-wsdl-publish-location
jasperPrint	jasper-print
java2jsMap	java-2-js-map
javaSourcesClassPath	java-sources-class-path
javaVMs	java-vms
javadocParser	javadoc-parser
javadocText	javadoc-text
javamodel_configuring_classpath_containers	javamodel-configuring-classpath-containers
jaxpVersionComboBox	jaxp-version-combo-box
jc	jc
jdk11Applet	jdk11-applet
jdkUpdate	jdk-update
je	je
jeeSpecRarDD	jee-spec-rar-dd
jf	jf
jjimageLen	jj-image-len
jl	jl
jp	jp
jr	jr
js	js
jspOutputAttrs	jsp-output-attrs
jspProperty	jsp-property
jt	jt
jumpToken	jump-token
jv	jv
jw	jw
k	k
k0	k-0
k1	k-1
k2	k-2
k3	k-3
kAEQuitApplication	k-ae-quit-application
kExternalizableValueHash	k-externalizable-value-hash
kRETURN	k-return
kc	kc
keyNames	key-names
keyPassNew	key-pass-new
keySize	key-size
keyStrokeTxt	key-stroke-txt
keyTypeInfo	key-type-info
keystoreName	key-store-name
kg	kg
ki	ki
kidOK	kid-ok
kl	kl
kn	kn
knownFileSystems	known-file-systems
knownHostsFileLabel	known-hosts-file-label
kp	kp
ks	ks
kt	kt
kv	kv
l	l
l1	l-1
l2	l-2
lHttpsProxyHost	l-https-proxy-host
lP	l-p
lPrintText	l-print-text
lTotalSeeds	l-total-seeds
lUserPassword	l-user-password
labSelectionTitle	lab-selection-title
labelPaintColor	label-paint-color
labelSortingAction	label-sorting-action
labelText	label-text
languageExtension	language-extension
languageFile	language-file
largeIconName	large-icon-name
lastAllocationWidth	last-allocation-width
lastButton	last-button
lastComputedName	last-computed-name
lastHolder	last-holder
lastModifiedCal	last-modified-cal
lastPrintable	last-printable
lastProcessedCategory	last-processed-category
lastShadowX	last-shadow-x
lastShadowY	last-shadow-y
lateTypeMungers	late-type-mungers
latestVersion	latest-version
layerResizeListener	layer-resize-listener
layouts	layouts
lb	lb
lblProjectName	lbl-project-name
lblRepo	lbl-repo
lblXmppError	lbl-xmpp-error
lc	lc
lcToken	lc-token
leafReached	leaf-reached
legendSettings	legend-settings
lengthInput	length-input
levelSpan	level-span
levelStrings	level-strings
lexerProblems	lexer-problems
lexicalAnalysis	lexical-analysis
lf	lf
li	li
libFolderCheckBox	lib-folder-check-box
licenseOptions	license-options
lifecycleResults	life-cycle-results
lifetimeDff	lifetime-dff
limitStartIndex	limit-start-index
line1Stroke	line1-stroke
lineMentionedMultipleTimes	line-mentioned-multiple-times
linkOffset	link-offset
listAvailable	list-available
listOfContactInfos	list-of-contact-infos
list___delslice___doc	list-delslice-doc
listenToParentDeactivate	listen-to-parent-deactivate
listenerMethod	listener-method
literalsPrefix	literals-prefix
lkpInfo	lkp-info
ll	ll
lm	lm
ln	ln
lo	lo
loadedImages	loaded-images
localAttrName	local-attr-name
localCu	local-cu
localId	local-id
localImage	local-image
localTime	local-time
locales	locales
localesLabel	locales-label
localsUsedInClassBodies	locals-used-in-class-bodies
lockThread	lock-thread
logNotSynced	log-not-synced
logPane	log-pane
logPath	log-path
logicalScreenWidth	logical-screen-width
loginButtonWidth	login-button-width
loginConfigStack	login-config-stack
loginLink	login-link
lookupKeys	lookup-keys
lowMemory	low-memory
lowerFrameCurLine	lower-frame-cur-line
lp	lp
lr	lr
ls	ls
lu	lu
lut4Arr	lut-4-arr
lv	lv
lx	lx
ly	ly
m	m
m0	m-0
m1	m-1
m2	m2
m3	m-3
mKeyStore	m-key-store
mLastSelected	m-last-selected
mOS_memmove_int	m-os-memmove-int
mPropertyExtListener	m-property-ext-listener
mRootDir	m-root-dir
mStartOnStart	m-start-on-start
m_ParameterList	m-parameter-list
m_additionalVectorsOffset_	m-additional-vectors-offset
m_backgroundPatternChanged	m-background-pattern-changed
m_barTextInsideFontStyle	m-bar-text-inside-font-style
m_cachedNodes	m-cached-nodes
m_checker	m-checker
m_doc_cache_off	m-doc-cache-off
m_emptyDataCount	m-empty-data-count
m_enterprise	m-enterprise
m_fragmentIDString	m-fragment-id-string
m_getActionCommand	m-get-action-command
m_hasTextLitOnly	m-has-text-lit-only
m_isBlocked	m-is-blocked
m_isOrdered	m-is-ordered
m_matchPattern	m-match-pattern
m_maxPeriod	m-max-period
m_mediatype	m-media-type
m_numberField	m-number-field
m_pixels	m-pixels
m_progressLinesIntervalMonthlyFirstLastDay	m-progress-lines-interval-monthly-first-last-day
m_runLength	m-run-length
m_scriptSrc	m-script-src
m_showForTasks	m-show-for-tasks
m_toolbar	m-toolbar
m_userParams	m-user-params
mainListener	main-listener
makeDecl	make-decl
makeFilepathProc	make-filepath-proc
managerChangeSupport	manager-change-support
manifestRawBytes	manifest-raw-bytes
manifestRoot	manifest-root
manipulators	manipulators
manyToManyOwnerSideEntityName	many-to-many-owners-ide-entity-name
manyToManyWhereTemplate	many-to-many-where-template
mapPrinter	map-printer
mapToAnnotations	map-to-annotations
mapViewCore	map-view-core
map_size_diff_reported	map-size-diff-reported
mappedByPropertyName	mapped-by-property-name
mappingTableG2a2	mapping-table-g-2-a2
mappingTableG2ac	mapping-table-g-2-ac
mappingTableG2ad	mapping-table-g-2-ad
mappingsToTraversals	mappings-to-traversals
margin	margin
markedStates	marked-states
markerAndSyncStamp	marker-and-sync-stamp
markerTable	marker-table
masterSet	master-set
matchArray	match-array
maxCacheMisses	max-cache-misses
maxFreeListSize	max-free-list-size
max_fails_for_live	max-fails-for-live
max_update_period	max-update-period
maxlevel	max-level
mb	mb
mc	mc
md	md
mdbRadio	mdb-radio
me	me
membershipChanged	membership-changed
memoryNotifInfo	memory-not-if-info
menuIdActionMap	menu-id-action-map
mercuryColor	mercury-color
mercuryPaint	mercury-paint
metaDataLocal	meta-data-local
metaType	meta-type
methodDeclLabel	method-decl-label
mf	mf
mg	mg
mh	mh
mi	mi
microDistance	micro-distance
minLength	min-length
minLineNumber	min-line-number
minPad	min-pad
minPartitionCapacity	min-partition-capacity
min_millis	min-millis
min_widths	min-widths
mismatchType	mismatch-type
mixedMode	mixed-mode
ml	ml
mm	mm
mo	mo
modalityMap	modality-map
modelsetter	model-setter
modifiedSinceCompile	modified-since-compile
moduleField	module-field
moduleJarValue	module-jar-value
moduleServiceName	module-service-name
monitorDir	monitor-dir
mouseHoverProc	mouse-hover-proc
movingEdges	moving-edges
movingWidget	moving-widget
mp	mp
mq	mq
ms	ms
mserver_	mserver
mt	mt
mu	mu
mult	mult
must	must
mute	mute
mv	mv
mvcs	mvcs
mvtc	mvtc
mw	mw
mx	mx
my	my
myAwtFont	my-awt-font
myColumnNumber	my-column-number
myCurrentTextField	my-current-text-field
myDF	my-df
myDS	my-ds
myFileFormatOption	my-file-format-option
myFileProperties	my-file-properties
myGPOptions	my-gp-options
myHttpStatusCode	my-http-status-code
myID	my-id
myId	my-id
myInjectable	my-injectable
myKi	my-ki
myLocationPoint	my-location-point
myMq	my-mq
mySelectLbl	my-select-lbl
myStableHolidays	my-stable-holidays
myUIConfiguration	my-ui-configuration
myZoomManager	my-zoom-manager
n	n
n1	n-1
n2	n-2
nDropTargets	n-drop-targets
nSrc	n-src
n_linefeeds	n-linefeeds
na	na
namePairs	name-pairs
nameSortRadioButton	name-sort-radio-button
namedImportScope	named-import-scope
namespaceComboBoxModel	name-space-combo-box-model
namespaceTextField	namespace-text-field
naturalIdPropertyNumbers	natural-id-property-numbers
natures_hasCycle	natures-has-cycle
nb	nb
nbm2unitCodeName	nbm-2-unit-code-name
nc	nc
nd	nd
ne	ne
needsArgumentCopy	needs-argument-copy
negotiator	negotiator
nestError	nest-error
nestedInclusions	nested-inclusions
newBufSize	new-buf-size
newProject	new-project
nextGenerationIndex	next-generation-index
nextLine	next-line
nextLink	next-link
nextMessageId	next-message-id
nextRefId	next-ref-id
nextShadowID	next-shadow-id
next_row_out	next-row-out
nf	nf
ng	ng
ni	ni
nightly_log	nightly-log
nl	nl
nm	nm
nn	nn
no	no
noGpCache	no-gp-cache
noMatchingLabelPanel	no-matching-label-panel
noRegistry	no-registry
no_input_rows	no-input-rows
no_visited_rows	no-visited-rows
nodeActionProvider	node-action-provider
nodeArtif	node-artif
node_id_history	node-id-history
nodesEntry	nodes-entry
noexec	no-exec
nonLLStarDecision	non-ll-star-decision
nonNullTypes	non-null-types
nonRedundantConcepts	non-redundant-concepts
normalBorder	normal-border
normalizedEOL	normalized-eol
normalizedPath	normalized-path
notRunModuleProgram	not-run-module-program
not_current_operand	not-current-operand
notificationPolicyClass_	notification-policy-class
nowZooming	now-zooming
nr	nr
ns	ns
nsPrefix	ns-prefix
nt	nt
nullAsEmptyMap	null-as-empty-map
nullDescriptor	null-descriptor
numLowConfidence	num-low-confidence
numSlots	num-slots
numValidFiles	num-valid-files
num_buckets	num-buckets
o	o
o1	o-1
o2	o-2
oa	oa
ob	ob
object2Node	object-2-node
objectID	object-id
objectId	object-id
objectNs	object-ns
obrFileName	obr-file-name
oc	oc
od	od
of	of
oglEnabled	ogl-enabled
oi	oi
ok	ok
okIfDisconnected	ok-if-disconnected
ol	ol
oldConfigName	old-config-name
oldGraph	old-graph
om	om
omitNorms	omit-norms
omitVisitors	omit-visitors
on	on
op	op
opc_dconst_0	opc-dconst-0
opc_dconst_1	opc-dconst-1
openInCompareAction	open-in-compare-action
openingTopComponents	opening-top-components
optUsePopulationCoding	opt-use-population-coding
or	or
orderingCheckBox	ordering-check-box
organization	organization
origBytecodeField	orig-byte-code-field
origLocationType	orig-location-type
originalEndOffset	original-end-offset
os	os
osfXK_Copy	osf-xk-copy
other_non_routable_total	other-non-routable-total
ourLastSelectedExporter	our-last-selected-exporter
outBufSize	out-buf-size
outChannel	out-channel
outParts	out-parts
outboxScrollPane	outbox-scroll-pane
outermostClass	outermost-class
outlineForOutlineLinkUri	outline-for-outline-link-uri
outputListener	output-listener
outputTCRef	output-tc-ref
outputWidth	output-width
overrideValue	override-value
ovrText	ovr-text
ow	ow
ownedWindowK	owned-window-k
ownedWindows	owned-windows
owningStmt	owning-stmt
p	p
p0	p-0
p1	p-1
p2	p-2
pA	p-a
pError	p-error
pHYs_TYPE	p-hys-type
pHYs_pixelsPerUnitYAxis	p-hys-pixels-per-unit-y-axis
pa	pa
pack200Info	pack200-info
packageDefinitionValid	package-definition-valid
packageNameProvider	package-name-provider
packagelistLoc	package-list-loc
pageBeansF	page-beans-f
pageFormWithNav	page-form-with-nav
paintingChild	painting-child
paletteImage	palette-image
palettes	palettes
paneOrientation	pane-orientation
panelDefaultValue	panel-default-value
paperWidthLabel	paper-width-label
parameter_not_set	parameter-not-set
parentCodeBase	parent-code-base
parentContext	parent-context
parentData	parent-data
parentResultSets	parent-result-sets
parentScopeObject	parent-scope-object
parentStack	parent-stack
parseError	parse-error
partialLoadSql	partial-load-sql
partyAInfo	party-a-info
passPhrase	pass-phrase
passivationMinIdleTime	passivation-min-idle-time
path_nullPath	path-null-path
pathsCount	paths-count
pathvar_whitespace	pathvar-whitespace
pauseChangeFlagChecker	pause-change-flag-checker
pb	pb
pc	pc
pd	pd
pe	pe
peekedTokenEnd	peeked-token-end
peer_listeners_aggregator	peer-listeners-aggregator
pendingApproval	pending-approval
pendingDataWidth	pending-data-width
pending_contacts	pending-contacts
perfCB	perf-cb
performanceConnectionTime	performance-connection-time
persistName	persist-name
pf	pf
ph	ph
phaseActionRecordsPairs	phase-action-records-pairs
phoneNumber	phone-number
phoneNumberLabel	phone-number-label
phrases	phrases
pi	pi
pieceFollowsCursor	piece-follows-cursor
pieceImages	piece-images
pinEditorItem	pin-editor-item
pk	pk
pkgToConstructorThrows	pkg-to-constructor-throws
pl	pl
platformsList	platforms-list
plotterList	plotter-list
pluginErrorLock	plugin-error-lock
pm	pm
po	po
popupTimesLabel	popup-times-label
portLabel	port-label
positionContainerPanel	position-container-panel
pp	pp
pq	pq
pr	pr
preResourceChangeListeners	pre-resource-change-listeners
prefTabSize	pref-tab-size
preload	preload
previewMessage	preview-message
previewSet	preview-set
previousReleaseID	previous-release-id
previousUrlDepth	previous-url-depth
previousUser	previous-user
privateKeyPasswordURL	private-key-password-url
privilegedGroupIds	privileged-group-ids
problemsCount	problems-count
processConditionalCommandsOnly	process-conditional-commands-only
processFiles	process-files
productionMode	production-mode
profileToDefaults	profile-to-defaults
profilerInterfaceInitialized	profiler-interface-initialized
profilingStateListeners	profiling-state-listeners
progressTextArea	progress-text-area
progressTitle	progress-title
projectEar	project-ear
projectEnd	project-end
projectFld	project-fld
projectIds	project-ids
projectLBL	project-lbl
projectMap	project-map
project_version	project-version
propGroup	prop-group
propagationBehavior	propagation-behavior
properties_qualifierIsNull	properties-qualifier-is-null
propertyInfo	property-info
propertyLaziness	property-laziness
property_to_attribute_map	property-to-attribute-map
protocolSet	protocol-set
protocolToJdbcTypes_	protocol-to-jdbc-types
providersToDisableOnLazyActions	providers-to-disable-on-lazy-actions
proxyInterface	proxy-interface
ps	ps
pt	pt
pu	pu
publicIdentifier	public-identifier
pucnHash	pucn-hash
pushedSOAPBinding	pushed-soap-binding
pv	pv
pw	pw
px	px
py	py
q	q
q0	q-0
q1	q-1
q2	q-2
q3	q-3
q4	q-4
q5	q-5
q6	q-6
q7	q-7
q8	q-8
q9	q-9
qa	qa
qb	qb
qc	qc
qd	qd
qe	qe
qf	qf
qq	qq
qs	qs
qt	qt
queryCacheRegion	query-cache-region
queryNestingDepth	query-nesting-depth
quickFilterObject	quick-filter-object
quickdiff_toggle_enable	quick-diff-toggle-enable
qw	qw
r	r
r1	r-1
r2	r-2
ra	ra
ratesFrom	rates-from
raw_content	raw-content
rb	rb
rc	rc
rd	rd
re	re
readAccess	read-access
readChunk	read-chunk
readOffsetShift	read-offset-shift
realHandlerService	real-handler-service
rebindPermOracle	rebind-perm-oracle
rebuildRequested	rebuild-requested
receive_buffer_size	receive-buffer-size
recv_thread	recv-thread
redirectOutPrintStream	redirect-out-print-stream
redirect_on_not_found	redirect-on-not-found
redirectorMethods	redirector-methods
redoAnalysis	redo-analysis
refAttrib	ref-attrib
refactoringPlugin	refactoring-plugin
referencedSequences	referenced-sequences
refreshRequestsTask	refresh-requests-task
regConditionNames	reg-condition-names
regionTextField	region-text-field
registeredFontFiles	registered-font-files
registryObjects	registry-objects
regularChoice	regular-choice
relationshipNameTextField	relationship-name-text-field
remoteFactory	remote-factory
remoteManagementSupported	remote-management-supported
remotePath	remote-path
remoteSensitivityChecked	remote-sensitivity-checked
remote_is_complete	remote-is-complete
renamingWhat	renaming-what
replaceFormatItems	replace-format-items
replaceMenu	replace-menu
replacesWindowFunctionCall	replaces-window-function-call
reportDeadCodeInTrivialIfStatement	report-dead-code-in-trivial-if-statement
reqHeaders	req-headers
requestLogHandler	request-log-handler
request_hint_supported	request-hint-supported
requestedId	requested-id
resTypeLabel	res-type-label
resolvedPointcutDeclaration	resolved-point-cut-declaration
resourcePool	resource-pool
resourceRoots	resource-roots
resources_flushingContentDescriptionCache	resources-flushing-content-description-cache
restrictedServlets	restricted-servlets
restrictionExpression	restriction-expression
resultPane	result-pane
resultPath	result-path
result_type	result-type
retentionPolicy	retention-policy
reverbForm	reverb-form
revokedCerts	revoked-certs
rf	rf
rh	rh
ri	ri
rightClip	right-clip
rl	rl
rm	rm
roleHint	role-hint
rootClassNameWildcard	root-class-name-wildcard
rootName	root-name
rootString	root-string
rowAllocator	row-allocator
rowObjects	row-objects
rowToModelIndex	row-to-model-index
row_count	row-count
rowsInput	rows-input
rp	rp
rq	rq
rr	rr
rs	rs
rt	rt
runStarts	run-starts
runToolkit	run-toolkit
runner	runner
rw	rw
s	s
s0	s-0
s1	s-1
s2	s-2
s3	s-3
s4	s-4
sa	sa
sampleId	sample-id
sampleNames	sample-names
sampledTimingLabel	sampled-timing-label
samplingPeriod	sampling-period
saveAllAndCommitText	save-all-and-commit-text
saveOnExit	save-on-exit
saveProblem	save-problem
saveablesSource	saveables-source
savedy	saved-y
savepointName_	savepoint-name
saving	saving
sawNullTestVeryOld	saw-null-test-very-old
sawStringIntern	saw-string-intern
sb	sb
sc	sc
scalarTypes	scalar-types
scaleToWidthLabel	scale-to-width-label
scan_code	scan-code
scannedBinaries2InvDependencies	scanned-binaries-2-inv-dependencies
schemaMod_	schema-mod
schemaModel	schema-model
schemeSpecificPart	scheme-specific-part
schemeUniqueNamesById	scheme-unique-names-by-id
scope_lhs	scope-lhs
scope_put	scope-put
scopedAspects	scoped-aspects
scopedRuleRefs	scoped-rule-refs
scratchScriptable	scratch-scriptable
scratch_file_name	scratch-file-name
scrollBeginTime	scroll-begin-time
sd	sd
se	se
searchChar	search-char
secondary_lookups	secondary-lookups
securityNode	security-node
seedOffset	seed-offset
seeding	seeding
segmentTotalSize	segment-total-size
sel_natMenuSelected_	sel-nat-enu-selected
seleBand	sele-band
selectConstructorAndTransformArguments	select-constructor-and-transform-arguments
selectLabel	select-label
selectedMake	selected-make
selectionWrittenLocalVariables	selection-written-local-variables
selection_clear_event	selection-clear-event
senders	senders
separateModeAccessors	separate-mode-accessors
seqBridge	seq-bridge
serializedTokens	serialized-tokens
seriesShapesFilled	series-shapes-filled
serverImpl	server-impl
serverInfo	server-info
serverReverseHistogramTypes	server-reverse-histogram-types
serviceAlreadyInstalled	service-already-installed
serviceManager	service-manager
servicePropertyList	service-property-list
servletRenderer	servlet-renderer
sessionReplaceCounter	session-replace-counter
setFilter	set-filter
setRequests	set-requests
setSpecialRegisterSection_	set-special-register-section
set_description	set-description
severity_description	severity-description
sf	sf
sg	sg
sh	sh
sharedContext	shared-context
shared_profile_not_found	shared-profile-not-found
shellList	shell-list
shortClassData	short-class-data
short_rightShift	short-right-shift
shouldExpand	should-expand
shouldStop	should-stop
showComparePaneAction	show-compare-pane-action
showCreateMIDlet	show-create-midlet
showExplorerStereotypes	show-explorer-stereotypes
showJavaMEBox	show-java-me-box
showPartPaneMenuAction	show-part-pane-menu-action
showTypes	show-types
showViewMenuAction	show-view-menu-action
si	si
siblingUrl	sibling-url
sigAlgName	sig-alg-name
sinceTag	since-tag
sk	sk
skipSelectionPage	skip-selection-page
skipSelectionsPage	skip-selections-page
slaves	slaves
slowness	slowness
sm	sm
smartSteppingFilterImpl	smart-stepping-filter-impl
sn	sn
snmpVersionThree	snmp-version-three
snodes	snodes
snoozeAgain	snooze-again
soInstallPct	so-install-pct
soToClipboard	so-to-clipboard
soapException	soap-exception
softCache	soft-cache
sortedTemplatesByParametrizedText	sorted-templates-by-parametrized-text
soundState	sound-state
sourceDirLabel	source-dir-label
sourceFileToLineNumberInfoMap	source-file-to-line-number-info-map
sourceInfo	source-info
sourceMethod	source-method
sourceReader	source-reader
sp	sp
spView	sp-view
spaceWithinIfParensDefault	space-within-if-parens-default
spanGrabExcessVerticalSpace	span-grab-excess-vertical-space
specComp	spec-comp
speciallyMaximized	specially-maximized
specifiedDeclCollection	specified-decl-collection
splitByAllocatables	split-by-allocatables
sq	sq
sqlStateIds	sql-state-ids
sr	sr
ss	ss
st	st
stackCount	stack-count
standardMapBackgroundColor	standard-map-background-color
startPage	start-page
startPath	start-path
startPoint	start-point
startRegexp	start-regexp
startRemember	start-remember
stateObjectFactory	state-object-factory
stateOffset	state-offset
statePoolTop	state-pool-top
statementContinuationIndent	statement-continuation-indent
staticAllowSingleThreadedModules	static-allow-single-threaded-modules
staticmethod_doc	static-method-doc
statsOnMs	stats-on-ms
statusTextHistory	status-text-history
stepSize	step-size
stickyTag	sticky-tag
stmtTable	stmt-table
stopTimeSlider	stop-time-slider
strFileSep	str-file-sep
str_swapcase_doc	str-swapcase-doc
stripOutlineVisible	strip-out-line-visible
stripeColor	stripe-color
su	su
su_count	su-count
subColMasks	sub-col-masks
subdir	sub-dir
subqueryList	subquery-list
subroutine	subroutine
subtitleFont	subtitle-font
suiteCounter	suite-counter
summaryField	summary-field
sunboot	sun-boot
supportInstantSubst	support-instant-subst
supportedLaFs	supported-la-fs
supportsLayerBStreaming_	supports-layer-b-streaming
sv	sv
sw	sw
sx	sx
sy	sy
syntaxDirection	syntax-direction
systemMenuManager	system-menu-manager
sz	sz
t	t
t0	t-0
t1	t-1
t2	t-2
t3	t-3
t4	t-4
tIVAR	t-ivar
tRBRACK	t-rbrack
tRNS_blue	trns-blue
ta	ta
tabAreaStyle	tab-area-style
tabButtonMap	tab-button-map
tab_char	tab-char
tableSubdataset	table-subdataset
tagSourceStart	tag-source-start
tailCoding	tail-coding
targetClassButton	target-class-button
targetDescriptionField	target-description-field
targetTheme	target-theme
taskParamLabel	task-param-label
taskPriority	task-priority
tb	tb
tblCreators	tbl-creators
tc	tc
td	td
te	te
tellNextTellerKeyStroke	tell-next-teller-key-stroke
tempLocal	temp-local
tempVector	temp-vector
templatesDir	templates-dir
termDocumentInformationFactoryByDocument	term-document-information-factory-by-document
termVecVal	term-vec-val
terminationCallback	termination-callback
ternaryConversionState	ternary-conversion-state
testSpecialProps	test-special-props
textCache	text-cache
textViewer	text-viewer
tf	tf
tfHostName	tf-host-name
tfSearch	tf-search
tfWorkingCopy	tf-working-copy
tg	tg
th	th
theModelManagementFactory	the-model-management-factory
thirdLineCaptionSpacer	third-line-caption-spacer
thisLine	this-line
threadCPUTimerOn	thread-cpu-timer-on
threadLocalStringBuilderHelper	thread-local-string-builder-helper
threadNames	thread-names
threadSerialNumberOffset	thread-serial-number-offset
threadStateMapping	thread-state-mapping
ti	ti
tiles	tiles
time0	time-0
time1	time-1
timeHeaderLabel	time-header-label
timeTable	time-table
timeoutExecutor	timeout-executor
timer	timer
timerIds	timer-ids
times	times
tinfo	t-info
titleLabel	title-label
titleString	title-string
tk	tk
tk_Principal	tk-principal
tl	tl
tm	tm
tmodel	t-model
tmpExt	tmp-ext
tmpKey	tmp-key
tn	tn
to	to
toBrowser	to-browser
toDate	to-date
toStringNullCheck	to-string-null-check
todoDate	todo-date
toggleToolBar	toggle-tool-bar
token2	token-2
tokenFilter	token-filter
token_	token
tokens	tokens
tomcatAttributes	tomcat-attributes
toolButtons	tool-buttons
toolTipResource	tool-tip-resource
toolset	toolset
tooltipErrLoopCount	tooltip-err-loop-count
topNodes	top-nodes
torrent	torrent
totalDuration	total-duration
totalFormat	total-format
totalOutputSize	total-output-size
total_fragment_permissible_type_count	total-fragment-permissible-type-count
tp	tp
tpBasis	tp-basis
tpcStack	tpc-stack
tps_listeners	tps-listeners
tr	tr
traceback___hash___doc	traceback-hash-doc
trackMuted	track-muted
trackedFolders	tracked-folders
trackedProjects	tracked-projects
trainrecog	train-recog
transactionManagerlookup	transaction-manager-lookup
transcode_file	transcode-file
transferStartTime	transfer-start-time
transformationFunction	transformation-function
transientPort	transient-port
transportBackChannel	transport-back-channel
triggerDefinition	trigger-definition
truncateEndOfTable	truncate-end-of-table
truncator	truncator
ts	ts
ts_x_origin	ts-x-origin
tspecials2NoSlash	t-specials-2-no-slash
tt	tt
tv	tv
tw	tw
twoStageSaveFile	two-stage-save-file
tx	tx
ty	ty
typeChar	type-char
typeHelper	type-helper
typeLanguage	type-language
typedInString	typed-in-string
typesToCheck	types-to-check
tz	tz
u	u
u1	u-1
u2	u-2
ub	ub
uc	uc
ui	ui
ul	ul
ulFreePrivateMemory	ul-free-private-memory
ullMax	ull-max
ullMin	ull-min
umlPackage	uml-package
un	un
undoCharsList	undo-chars-list
unenlisted	un-enlisted
uniqueArrayBindings	unique-array-bindings
uniqueIntId	unique-int-id
uniqueParameterizedGenericMethodBindings	unique-parameterized-generic-method-bindings
unitCache	unit-cache
unknownAnnotation	unknown-annotation
unmodifiableValidationStatus	unmodifiable-validation-status
unsharedBottomField	unshared-bottom-field
unwrapLock	unwrap-lock
up	up
update	update
updateAfterFoldHierarchyChange	update-after-fold-hierarchy-change
updateLevel	update-level
updatedPanel	updated-panel
updatedRowCtx	updated-row-ctx
updownselect	updown-select
upgradejarpath	upgrade-jar-path
uppercaseHash	uppercase-hash
uq	uq
ur	ur
uriqaServerUrl	uriqa-server-url
urlLabel	url-label
urlPatternPanel	url-pattern-panel
url_resolveFragment	url-resolve-fragment
url_resolvePlugin	url-resolve-plugin
us	us
usageCB	usage-cb
usageHistCount	usage-hist-count
use32Threading	use32-threading
useBuffer	use-buffer
useCached	use-cached
useCaches	use-caches
useCanonCaches	use-canon-caches
useCompactIndex	use-compact-index
useDefaultOnMissingResource	use-default-on-missing-resource
useErrorIcon	use-error-icon
useSendfile	use-send-file
usedRules	used-rules
userEntries	user-entries
userGrouperId	user-grouper-id
userLibraries	user-libraries
userMatcher	user-matcher
userMinInterval	user-min-interval
userNameTable	user-name-table
userPathStorage	user-path-storage
userSuppliedOptimizerOverrides	user-supplied-optimizer-overrides
usesSqlAuthorization	uses-sql-authorization
ut	ut
ux	ux
uy	uy
v	v
v1	v-1
v2	v-2
v3	v-3
v6	v-6
vY	v-y
validCall	valid-call
validModes	valid-modes
validatableImplementor	validatable-implementor
validationResult	validation-result
valueAnnotationType	value-annotation-type
valueIndirection_	value-indirection
value_details_snapshot	value-details-snapshot
valuelen	value-len
varArg	var-arg
variant	variant
vb	vb
vc	vc
ve	ve
verboseCheckBox	verbose-check-box
verify_password	verify-password
versionOptions	version-options
verticalAxisTrace	vertical-axis-trace
vf	vf
vg	vg
vhost	vhost
viewFactoryClass	view-factory-class
viewTitleInfo	view-title-info
visibleCheckBox	visible-check-box
visibleRow	visible-row
visitingMethod	visiting-method
vm	vm
vn	vn
vp	vp
vs	vs
vt	vt
w	w
w0	w0
w2	w-2
waitLock	wait-lock
warehouse	warehouse
warnCount	warn-count
warnedNames	warned-names
wasHelpUnavailable	was-help-unavailable
wasSet	was-set
wc	wc
wd	wd
weakLookup	weak-lookup
webApps	web-apps
webEjbJarProvider	web-ejb-jar-provider
whiteboardComboBox	whiteboard-combo-box
wideFactor	wide-factor
windowStartIndex	window-start-index
wkstarthr	wk-start-hr
wm	wm
wombatLeft	wombat-left
workDirectory	work-directory
workingDirectoryButtonGroup	working-directory-button-group
wp	wp
wr	wr
wrappedException	wrapped-exception
wrapperLifecycles	wrapper-lifecycles
writeObjectMethods	write-object-methods
writtenOutsideOfInitializationFields	written-outside-of-initialization-fields
ws	ws
wsBrowsed	ws-browsed
wsContext	ws-context
wsDataSourceClass	ws-data-source-class
wt	wt
wv	wv
ww	ww
x	x
x0	x-0
x1	x-1
x2	x-2
xRoot	x-root
xa	xa
xc	xc
xe	xe
xf	xf
xh	xh
xi	xi
xl	xl
xml11DTDValidatorsCurrentSize	xml11-dtd-validators-current-size
xmlReferenceBuilderMap	xml-reference-builder-map
xo	xo
xp	xp
xr	xr
xs	xs
xt	xt
xw	xw
xx	xx
xy	xy
xz	xz
y	y
y0	y-0
y1	y-1
y2	y-2
yClient	y-client
ya	ya
yh	yh
yo	yo
youngerWindow	younger-window
yx	yx
yy	yy
yy_old_buffer	yy-old-buffer
yychar	yy-char
yz	yz
z	z
ze	ze
zo	zo
zs	zs
zx	zx
zy	zy
zz	zz
