$param_arrayOf_ObjectName_1	param-array-of-object-name-1
A	a
AL	al
AT	at
B	b
B1	b1
B2	b2
BE	be
Bl	bl
C	c
CT	ct
CUP$Grm$parser	cup-grm-parser
CUP$Parser$top	cup-parser-top
CUP$parser$act_num	cup-parser-act-num
CanonicalizationMethodElem	canonicalization-method-elem
CppTokenId	cpptokenid
D	d
D1	d-1
D2	d-2
DN	dn
DO	do
E	e
E0	e-0
E1	e-1
E2	e-2
F	f
F1	f-1
F2	f-2
FD	fd
G	g
GP	gp
Gl	gl
H	h
H1	h-1
H2	h-2
HMACOutputLength	hmac-output-length
I	i
I1	i-1
I2	i-2
ID	id
IV	iv
Id	id
J	j
JPA2ElementCollection	jpa2-element-collection
K	k
KB	kb
KX	kx
Ki	ki
L	l
L1	l-1
L2	l-2
LOBReference	lob-reference
M	m
M1	m-1
M2	m-2
MCU_data	mcu-data
N	n
NT	nt
Nm	nm
P	p
PC	pc
Q	q
R	r
Rl	rl
S	s
SQLtype	sql-type
SSLCARevocationFile	sslca-revocation-file
ST	st
T	t
Tx	tx
U	u
U1	u-1
U2	u-2
UserName	user-name
V	v
W	w
X	x
XB	xb
Y	y
Z	z
_	
_B	b
_K	k
_a	a
_already_encoded	already-encoded
_applicationName	application-name
_b	b
_backgrounds	backgrounds
_bt_have_version	bt-have-version
_check_instance	check-instance
_chunk_size	chunk-size
_close_input_stream	close-input-stream
_columnNumber	column-number
_context_id	context-id
_dht_receive_delay	dht-receive-delay
_e	e
_encoding	encoding
_error_listener	error-listener
_except	except
_f	f
_file_offset	file-offset
_foreigns	foreigns
_fully_initialise	fully-initialise
_g	g
_goodPingInMilliSec	good-ping-in-milli-sec
_header	header
_history	history
_i	i
_iterator	iterator
_k	k
_keystore_password	keystore-password
_locale	locale
_low_priorty	low-priorty
_m	m
_magic	magic
_major_version	major-version
_maxOccurs	max-occurs
_node	node
_other_id	other-id
_p	p
_persistent	persistent
_piece_version	piece-version
_r	r
_read_cipher	read-cipher
_reply_status	reply-status
_requests	requests
_s	s
_slices	slices
_slot_type	slot-type
_substDisallowed	subst-disallowed
_switch_read	switch-read
_t	t
_tracker	tracker
_transfer_size_estimate	transfer-size-estimate
_transient	transient
_u	u
_urls	urls
_user	user
_uuid	uuid
_v	v
_validPolicy	valid-policy
_x	x
_y	y
a	a
a0	a-0
a1	a-1
a2	a-2
a3	a-3
a4	a-4
a5	a-5
a6	a-6
a7	a-7
a8	a-8
aButton	a-button
aCanvasHasFocus	a-can-vas-has-focus
aClassIDNoAlloc	a-class-id-no-alloc
aColor	a-color
aConfigurer	a-configurer
aControl	a-control
aDialogTitle	a-dialog-title
aE	a-e
aFilterDescriptor	a-filter-descriptor
aFlavor	a-flavor
aH	a-h
aHostsWithPortsArray	a-hosts-with-ports-array
aLoadType	a-load-type
aMaxSelfProgress1	a-max-self-progress-1
aMaxSelfProgress2	a-max-self-progress-2
aMemento	a-memento
aMethodOrConstructor	a-method-or-constructor
aNativeLeafName	a-native-leaf-name
aObserver	a-observer
aOutputStream	a-output-stream
aPercentPhasesComplete	a-percent-phases-complete
aResolver	a-resolver
aServerTime	a-server-time
aSourceURI	a-source-uri
aSourceUrl	a-source-url
aSuite	a-suite
aTargetFileIsExecutable	a-target-file-is-executable
aTempFile	a-temp-file
aTypeVariableBinding	a-type-variable-binding
aW	a-w
aWindowTitle	a-window-title
aWorkQueue	a-work-queue
aa	aa
ab	ab
abits	abits
aboveButtons	above-buttons
absPath	abs-path
absolutePathOrNativeFileItem	absolute-path-or-native-file-item
abstractNamespace	abstract-namespace
ac	ac
acTables	ac-tables
acceptArgs	accept-args
acceptCharset	accept-charset
acceptIfSameNumberParams	accept-if-same-number-params
accessOrder	access-order
accessTimeout	access-timeout
accessedCols	accessed-cols
accumulate	accumulate
accumulateOnly	accumulate-only
aclient	a-client
act_tab	act-tab
actionBeanContext	action-bean-context
actionGroups	action-groups
actionLabels	action-labels
actionMapper	action-mapper
actionsEnabled	actions-enabled
activateWithPreviousValues	activate-with-previous-values
activatedView	activated-view
activationSet	activation-set
activeNotebookUri	active-notebook-uri
activeRunAsType	active-run-as-type
activeWorkbenchWindow	active-workbench-window
actualModuleList	actual-module-list
actualResources	actual-resources
actualReturnType	actual-return-type
actualShortcut	actual-shortcut
actualTypeArgs	actual-type-args
ad	ad
adapterId	adapter-id
addAjSynthetic	add-aj-synthetic
addClasspathChange	add-classpath-change
addConfig	add-config
addDefaultCssStyle	add-default-css-style
addLine	add-line
addMemberMessageRequest	add-member-message-request
addSerialVersionIds	add-serial-version-ids
addThisQualifier	add-this-qualifier
addUuid	add-uuid
additionalActions	additional-actions
additionalArgs	additional-args
additionalIndent	additional-indent
additionalReservedNames	additional-reserved-names
additionalWidth	additional-width
addproperty	add-property
addrType	addr-type
addressSize	address-size
addressingDisposition	addressing-disposition
adminDDBean	admin-dd-bean
advised	advised
advisor	advisor
ae	ae
af	af
afterExecution	after-execution
ag	ag
again	again
aggregateVector	aggregate-vector
agreement	agreement
agressive	agressive
ah	ah
ai	ai
aidFromFile	aid-from-file
al	al
alarmState	alarm-state
algoSuite	algo-suite
alignValue	align-value
alignment	alignment
alignmentX	alignment-x
alignmentY	alignment-y
alignments	alignments
allAbilities	all-abilities
allClusterModules	all-cluster-modules
allGlobals	all-globals
allNodeCollection	all-node-collection
allPreferences	all-preferences
allProperties	all-properties
all_peers	all-peers
allfiles	all-files
allocation	allocation
allowAutoboxing	allow-auto-boxing
allowCollapse	allow-collapse
allowComment	allow-comment
allowFiltering	allow-filtering
allowLiteralNumbers	allow-literal-numbers
allowMoveUp	allow-move-up
allowNewFiles	allow-new-files
allowToGoUp	allow-to-goup
alreadyChecked	already-checked
alternateAddTag	alternate-add-tag
alwaysOnTop	always-on-top
alwaysVisible	always-visible
am	am
ambigEx	ambig-ex
an	an
anOutputStream	an-output-stream
analysisResultType	analysis-result-type
analyzeOut1	analyze-out-1
ancestorName	ancestor-name
ancestorTagClass	ancestor-tag-class
anchorPath	anchor-path
annosDupl	annos-dupl
annotationPrefernceIterator	annotation-prefernce-iterator
annotationTargetKinds	annotation-target-kinds
annotationTypeMappings	annotation-type-mappings
annotationsToSearch	annotations-to-search
anotherInteger	another-integer
anotherKey	another-key
anotherLong	another-long
antProjectProperties	ant-project-properties
ao	ao
aoResource	ao-resource
ap	ap
apmClass	apm-class
appArgs	app-args
appRequester	app-requester
appdataPath	app-data-path
appendResolvedVariables	append-resolved-variables
appenderTable	appender-table
applicationMap	application-map
appointment	appointment
ar	ar
archivePath	archive-path
arg237	arg-237
arg238	arg-238
arg239	arg-239
arg240	arg-240
arg241	arg-241
arg242	arg-242
arg243	arg-243
arg244	arg-244
arg245	arg-245
arg246	arg-246
arg247	arg-247
arg248	arg-248
arg249	arg-249
argFile	arg-file
argNode	arg-node
argStaticMod	arg-static-mod
argTimestamp	arg-timestamp
argumentNumber	argument-number
arrayReader	array-reader
arrayString	array-string
artifactIncludes	artifact-includes
artifactKey	artifact-key
as	as
asLocation	as-location
asMemberOf	as-member-of
asSymbols	as-symbols
asTableFunction	as-table-function
asText	as-text
ascComparator	asc-comparator
aspectElement	aspect-element
assPlugin	ass-plugin
assemblageInformation	assemblage-information
assignRoles	assign-roles
assistNode	assist-node
assnVarMeta	assn-var-meta
associationTableBinder	association-table-binder
astoffset	ast-offset
at	at
attlistDecl	attlist-decl
attrRawName	attr-raw-name
attrSet	attr-set
attrTag	attr-tag
attrURI	attr-uri
attributeDefName	attribute-def-name
attributeMarkerGrouping	attribute-marker-grouping
attributeSeparatorIndex	attribute-separator-index
attributeTable	attribute-table
au	au
audit	audit
auditCfg	audit-cfg
authenticationType	authentication-type
authorizedRoles	authorized-roles
autoExpandMode	auto-expand-mode
autoGrowNullReferences	auto-grow-null-references
autoHideOrderColumnIDs	auto-hide-order-column-ids
autoIncrementInfo	auto-increment-info
autoPrefix	auto-prefix
autoWidthMethod	auto-width-method
auto_dl	auto-dl
autoadd	auto-add
automation	automation
autowireStrategy	autowire-strategy
autowiredAnnotationTypes	autowired-annotation-types
av	av
aw	aw
awtColor	awt-color
ax	ax
axesInfoElement	axes-info-element
axisKey	axis-key
axisSettings	axis-settings
ay	ay
b	b
b0	b-0
b1	b-1
b2	b-2
b3	b-3
b4	b-4
b5	b-5
b6	b-6
b7	b-7
bAdmin	b-admin
bElement	b-element
bFollowSelected	b-follow-selected
bIncludeDND	b-include-dnd
bInitialState	b-initial-state
bPKschema	b-pk-schema
bProcedure	b-procedure
bV	b-v
ba	ba
backColor	back-color
backlog	backlog
backref	backref
backward	backward
barRectHeight	bar-rect-height
barcodeBean	barcode-bean
base64	base64
baseArgumentCount	base-argument-count
baseClassName	base-class-name
baseFontSize	base-font-size
baseLocalDirectory	base-local-directory
baseLookup	base-lookup
baseModule	base-module
baseOnly	base-only
baseProject	base-project
baseProjects	base-projects
baseTestName	base-test-name
base_cc	base-cc
base_code	base-code
basedOn	based-on
baselineCost	baseline-cost
baselineLocation	baseline-location
baselineStartDate	baseline-start-date
basenamePrefix	basename-prefix
batchsize	batch-size
bb	bb
bc	bc
bd	bd
be	be
beanFactoryToProcess	bean-factory-to-process
beanSource	bean-source
before	before
beforeStatus	before-status
beginEx	begin-ex
bf	bf
bg	bg
bh	bh
bi	bi
binIncl	bin-incl
binaryAnnotations	binary-annotations
binaryClassName	binary-class-name
binaryNameSourceNamePair	binary-name-source-name-pair
bindFile	bind-file
bindedComponent	binded-component
binding	binding
bindingHandlerFO	binding-handler-fo
birthday	birthday
bitNames	bit-names
bitsPerPixel	bits-per-pixel
bj	bj
bk	bk
bl	bl
blackOutline	black-outline
blocNumber	bloc-number
blockDefault	block-default
bm	bm
bn	bn
bo	bo
board	board
boardData	board-data
bodyStore	body-store
bomRequest	bom-request
bomRevision	bom-revision
bootProperties	boot-properties
bootingDictionary	booting-dictionary
borderBottomStyle	border-bottom-style
borderTitleBundleKey	border-title-bundle-key
bottomColor	bottom-color
bottomHeight	bottom-height
boundary_type	boundary-type
boundsControl	bounds-control
boxObject	box-object
bp	bp
bpelProjDir	bpel-proj-dir
bq	bq
br	br
breakOrContinue	break-or-continue
bridges	bridges
bridgingSetter	bridging-setter
brokerAbstractName	broker-abstract-name
browserWindow	browser-window
bs	bs
bstart	b-start
bt	bt
btnTwoKey	btn-two-key
bufferPool	buffer-pool
buildConfigFile	build-config-file
buildFileLocation	build-file-location
buildFirst	build-first
buildResultFolder	build-result-folder
bundleDesc	bundle-desc
bundlePrefix	bundle-prefix
bundleStrProp	bundle-str-prop
buttonEnabled	button-enabled
buttonPos	button-pos
bv	bv
bw	bw
bx	bx
bxMin	bx-min
by	by
bytesUploaded	bytes-uploaded
c	c
c0	c-0
c1	c-1
c2	c-2
c3	c-3
c4	c-4
cA	c-a
cArea	c-area
cH	c-h
cM	c-m
cPath	c-path
cR	c-r
cRLIssuer	c-rl-issuer
cTask	c-task
cWhatsNew	c-whats-new
c_	c
ca	ca
caText	ca-text
cacheConfig	cache-config
cacheConfigPath	cache-config-path
cacheInstanceManager	cache-instance-manager
cacheObjectMaxSize	cache-object-max-size
cacheProviderConfig	cache-provider-config
cacheType	cache-type
cachedGrammar	cached-grammar
calledFromSetText	called-from-set-text
callstackLine	call-stack-line
canBeEmpty	can-be-empty
canBeVoid	can-be-void
canChange	can-change
canClose	can-close
canEditAsText	can-edit-as-text
canReplaceGlobalMacro	can-replace-global-macro
cancelOperation	cancel-operation
candidateBeans	candidate-beans
candidateParent	candidate-parent
caseOrderUpper	case-order-upper
caseSensitiveMounts	case-sensitive-mounts
casesFile	cases-file
catalogDate	catalog-date
categoryAxisLabel	category-axis-label
categoryCount	category-count
categoryDefinitions	category-definitions
categoryParameterName	category-parameter-name
category_image_id	category-image-id
causeByException	cause-by-exception
cb	cb
cc	cc
cd	cd
ce	ce
cellContents	cell-contents
cellParent	cell-parent
certSubject	cert-subject
certificate1	certificate-1
certificate2	certificate-2
certificates	certificates
cf	cf
cfName	cf-name
cfgTemplates	cfg-templates
cg	cg
cgiPathPrefix	cgi-path-prefix
ch	ch
changeFile	change-file
changeFlag	change-flag
changedAST	changed-ast
changedCategories	changed-categories
changedControl	changed-control
changedData	changed-data
changedFiles	changed-files
changedir	change-dir
characterPosition	character-position
characterReference	character-reference
charsetResource	charset-resource
chartHeight	chart-height
checkChildren	check-children
checkCommitExclusions	check-commit-exclusions
checkExcluded	check-excluded
checkFunDefition	check-fun-defition
checkGesture	check-gesture
checkInterval	check-interval
checkLoaded	check-loaded
checkSharability	check-sharability
checkedResources	checked-resources
checkoutByDate	checkout-by-date
checkpoint	check-point
childContext	child-context
childElem	child-elem
childName	child-name
childPanel	child-panel
childToSearchIndex	child-to-search-index
childrenFolderLayer	children-folder-layer
childrenWidth	children-width
chronology	chronology
ci	ci
cj	cj
ck	ck
cl	cl
classFileCompoundNames	class-file-compound-names
classFileReader	class-file-reader
classNode	class-node
classPathElement	class-path-element
classPersisterClass	class-persister-class
classPrefixes	class-prefixes
class_hints	class-hints
class_name	class-name
classesOnly	classes-only
classificationMap	classification-map
classpathEl	classpath-el
classpathEntryName	classpath-entry-name
classpathId	classpath-id
classpathMap	classpath-map
clauseAsInt	clause-as-int
cleanCommand	clean-command
cleanUpCheck	clean-up-check
cleanupContext	cleanup-context
clearBuffer	clear-buffer
clipHeight	clip-height
clipMode	clip-mode
cloneByRef	clone-by-ref
cloneVm	clone-vm
cloningDoc	cloning-doc
closeOperation	close-operation
closeableSource	closeable-source
closingParts	closing-parts
clox	clox
cloy	cloy
cls1	cls-1
cls2	cls-2
clsf	clsf
clss	clss
clup	clup
clusterPathList	cluster-path-list
clzz	clzz
cm	cm
cmToConnectionsMap	cm-to-connections-map
cmap	cmap
cmax	cmax
cmcu	cmcu
cmd1	cmd-1
cmd2	cmd-2
cmdinfo	cmd-info
cmdl	cmdl
cmdname	cmd-name
cmds	cmds
cmin	cmin
cmndName	cmnd-name
cmpi	cmpi
cmps	cmps
cmpv	cmpv
cn	cn
co	co
codeNameBase	code-name-base
codePointCheck	code-point-check
codeSnippet	code-snippet
collationType	collation-type
collected	collected
collectionElement	collection-element
collectionNode	collection-node
collectionReturn	collection-return
collectionValue	collection-value
collector	collector
colnames	col-names
colorTable	color-table
colsWeWant	cols-we-want
columnAlias	column-alias
columnElement	column-element
columnGroupIndex	column-group-index
combine	combine
commandIdIn	command-id-in
commandProvider	command-provider
comp1Id	comp-1-id
comp2Id	comp-2-id
compBounds	comp-bounds
compUnitPath	comp-unit-path
compileMode	compile-mode
compilerAnnotation	compiler-annotation
compilerWorkDir	compiler-work-dir
complexContentElement	complex-content-element
complexity	complexity
componentDescriptorConfiguration	component-descriptor-configuration
componentList	component-list
componentNames	component-names
componentToAdd	component-to-add
compress	compress
comptype	comp-type
concatKeyword	concat-keyword
conceptLabel	concept-label
concreteMarker	concrete-marker
concurrentExecutor	concurrent-executor
conditionResult	condition-result
confDescriptor	conf-descriptor
configErrMsg	config-err-msg
configPropertyMetaData	config-property-meta-data
configProps	config-props
configurationListener	configuration-listener
configurationVersion	configuration-version
configureLog	configure-log
connectionDefinitionAnnotation	connection-definition-annotation
connectionPoolTimeout	connection-pool-timeout
connectionsDestroyed	connections-destroyed
connectorModuleBuilder	connector-module-builder
consDesc	cons-desc
conservative	conservative
considerOnlyStrictDependency	consider-only-strict-dependency
considerOverrides	consider-overrides
consider_diversification	consider-diversification
consoleSession	console-session
constName	const-name
constantExpression	constant-expression
constantMethodref	constant-method-ref
constraintElement	constraint-element
constructorDeclaration	constructor-declaration
consumedEvents	consumed-events
containerPath	container-path
containingBd	containing-bd
containingDir	containing-dir
containingScope	containing-scope
containsLocalTypes	contains-local-types
contentDescription	content-description
contentDisposition	content-disposition
contentLabel	content-label
contentMargins	content-margins
contentSpecIndex	content-spec-index
context1	context-1
contextFactory	context-factory
contextFlags	context-flags
contextHandlers	context-handlers
contextMode	context-mode
contextTypeName	context-type-name
contexts	contexts
contrView	contr-view
contributeDependencies	contribute-dependencies
contributionName	contribution-name
controlData	control-data
controller	controller
controllerHandler	controller-handler
conversionHelper	conversion-helper
convertMethod	convert-method
cookie_name	cookie-name
copyLen	copy-len
copySources	copy-sources
copySubDirs	copy-sub-dirs
corbaConnection	corba-connection
corbaGBeanNameSourceCollection	corba-g-bean-name-source-collection
coreName	core-name
couldBeZero	could-be-zero
countArg	count-arg
cout	c-out
coverageRateAsPercentage	coverage-rate-as-percentage
cp	cp
cpListElements	cp-list-elements
cpRefs	cp-refs
cpResults	cp-results
cpSupportCallback	cp-support-callback
cparent	c-parent
cpes	cpes
cpmd	cpmd
cpoolx	c-pool-x
cpos	cpos
cppSet	cpp-set
cpve	cpve
cpx0	cpx-0
cpx1	cpx-1
cpx2	cpx-2
cpy0	cpy-0
cpy1	cpy-1
cq	cq
cr	cr
crc1	crc-1
crc2	crc-2
createEmptyFiles	create-empty-files
createPackage	create-package
createResolver	create-resolver
createTCTime	create-tc-time
createThread	create-thread
cred	cred
crit	crit
criteriaInst	criteria-inst
criterionValue	criterion-value
crle	crle
crlf	crlf
crls	crls
cron	cron
cs	cs
csID	cs-id
csca	csca
cset	cset
csig	csig
csmObjects	csm-objects
csms	csms
cssProperty	css-property
cssStyleData	css-style-data
csso	csso
ct	ct
ctors	ctors
ctrlKeyArg	ctrl-key-arg
cu	cu
curPtrPos	cur-ptr-pos
curSuggestion	cur-suggestion
curpwd	cur-pwd
currCD	curr-cd
currDownloadLimit	curr-download-limit
currOp	curr-op
currSchema	curr-schema
currentAnonymousLocalType	current-anonymous-local-type
currentConfiguration	current-configuration
currentCount	current-count
currentEntry	current-entry
currentEventHandler	current-event-handler
currentFormOnly	current-form-only
currentPageId	current-page-id
currentResource	current-resource
currentSprint	current-sprint
currentTagRead	current-tag-read
currentTextEditor	current-text-editor
cursToCopy	curs-to-copy
cursorName	cursor-name
customColumn	custom-column
customEncoding	custom-encoding
customInterpolator	custom-interpolator
customItemLabel	custom-item-label
customItemListLabelMnemonic	custom-item-list-label-mnemonic
customQualifierTypes	custom-qualifier-types
customSQLDelete	custom-sql-delete
customWrite	custom-write
cutDown	cut-down
cv	cv
cw	cw
cx	cx
cy	cy
cymin	cymin
d	d
d1	d-1
d2	d-2
dB	db
dList	d-list
dN	d-n
dObject	d-object
dP	d-p
dQ	d-q
da	da
dataFlavors	data-flavors
dataTablesMetadata	data-tables-metadata
dataTypeName	data-type-name
dataView	data-view
data_id	data-id
data_in	data-in
data_out	data-out
data_sources	data-sources
data_svg	data-svg
databasePlatform	database-platform
databaseProductName	database-product-name
databuf	data-buf
datapath	data-path
dateFieldModel	date-field-model
dateOnly	date-only
dayOffColor	day-off-color
db	db
dbProperties	db-properties
dbProps	db-props
dc	dc
dcp_register	dcp-register
dd	dd
ddPrefix	dd-prefix
de	de
deallocateKeyword	deallocate-keyword
debugLevel	debug-level
debugSource	debug-source
decider	decider
declarationNodes	declaration-nodes
declarations	declarations
declaringTypeName	declaring-type-name
declination	declination
decodeOffset	decode-offset
decreaseFactor	decrease-factor
defSize	def-size
defauilt	defauilt
defaultAlpha	default-alpha
defaultApplet	default-applet
defaultCascade	default-cascade
defaultCollectionFieldRenderer	default-collection-field-renderer
defaultDirections	default-directions
defaultGenerator	default-generator
defaultNameFormatter	default-name-formatter
defaultNamespaceRemap	default-namespace-remap
defaultNetworkConnectorName	default-network-connector-name
defaultPassphrase	default-passphrase
defaultPkgPrefix	default-pkg-prefix
defaultSchemaName	default-schema-name
defaultSetter	default-setter
defaultSorter	default-sorter
defaultStatement	default-statement
defaultSuffixes	default-suffixes
defaultTemplate	default-template
defaultValueEnd	default-value-end
defaultWS	default-ws
default_object	default-object
defaulter	defaulter
defaultfolder	default-folder
definitionHolder	definition-holder
delayTime	delay-time
delegate	delegate
delegateCount	delegate-count
delegateGrammar	delegate-grammar
delegateNode	delegate-node
delegatedTo	delegated-to
deleteQuoted	delete-quoted
delimString	delim-string
delivery_d	delivery-d
denormalizedSuperTable	denormalized-super-table
dependants	dependants
dependencyManager	dependency-manager
depending	depending
deployable	deployable
dereferencer	dereferencer
derivation_s	derivation-s
derivedFrom	derived-from
desiredLocale	desired-locale
destBase	dest-base
destCM	dest-cm
destCS	dest-cs
destClassifier	dest-classifier
destJar	dest-jar
destOffset	dest-offset
destOfs	dest-ofs
destOs	dest-os
destRoot	dest-root
destSD	dest-sd
dest_ptr	dest-ptr
dest_w	dest-w
dest_x	dest-x
dest_y	dest-y
destroyMethodName	destroy-method-name
detailArg	detail-arg
detailLabel	detail-label
detailsMessage	details-message
detailsMsg	details-msg
deviceEventType	device-event-type
df	df
dg	dg
dh	dh
di	di
dialectClasses	dialect-classes
dialogEmptyMessage	dialog-empty-message
dialogSettingsStore	dialog-settings-store
diffLength	diff-length
differentLocalsCount	different-locals-count
digestAlgorithm	digest-algorithm
digestName	digest-name
digester	digester
diiRequest	dii-request
dirMode	dir-mode
dirPrefix	dir-prefix
dirVisTypes	dir-vis-types
directionEstimator	direction-estimator
directionForward	direction-forward
directoryList	directory-list
dirtyCheckEventListener	dirty-check-event-listener
disabledRec	disabled-rec
discAnn	dis-cann
discard_non_versioned_when_versioned_found	discard-non-versioned-when-versioned-found
discolorTemporaryAnnotation	discolor-temporary-annotation
disconnected	disconnected
discovery	discovery
discoverySiteInfo	discovery-site-info
discrepancy	discrepancy
dispatchMethod	dispatch-method
dispatcherHolder	dispatcher-holder
displayArea	display-area
displayErrorMessage	display-error-message
displayPkgName	display-pkg-name
distributedTreeManager	distributed-tree-manager
dl	dl
dlgTitle	dlg-title
dm	dm
dmnem	dmnem
dmtce	dmtce
dn	dn
doGradient	do-gradient
doInternalWork	do-internal-work
doListen	do-listen
doOpenStores	do-open-stores
doOperation	do-operation
doScroll	do-scroll
doStart	do-start
doTestT	do-test-t
do_skip	do-skip
docLine	doc-line
docLink	doc-link
docList	doc-list
docLocator	doc-locator
docOrFile	doc-or-file
docTypeInternalSubset	doc-type-internal-subset
docTypeRootElementName	doc-type-root-element-name
docsScoredInOrder	docs-scored-in-order
dodgy_client	dodgy-client
domainDir	domain-dir
domainDoc	domain-doc
dotPrefix	dot-prefix
doubleField	double-field
doubleOnclick	double-on-click
doubleOnselect	double-on-select
doubleParam	double-param
downButton	down-button
downMax	down-max
downMin	down-min
downloadIndex	download-index
dp	dp
dr	dr
dragDetect	drag-detect
dragEvent	drag-event
drawPaint	draw-paint
drawStroke	draw-stroke
drawable	drawable
drawingGraphics	drawing-graphics
driveLetter	drive-letter
driverClass	driver-class
driverEnabled	driver-enabled
dropSupport	drop-support
ds	ds
dsHeader	ds-header
dstMax	dst-max
dstMin	dst-min
dstOff	dst-off
dstOut	dst-out
dt	dt
du	du
dueDate	due-date
dummyPart	dummy-part
dumpInt	dump-int
dumpString	dump-string
durableSubscriptionName	durable-subscription-name
durationFail	duration-fail
dv	dv
dvFactory	dv-factory
dw	dw
dx	dx
dy	dy
dyanamicImport	dyanamic-import
dynAny	dyn-any
e	e
e0	e-0
e1	e-1
e2	e-2
e3	e-3
e4	e-4
e5	e-5
e6	e-6
e7	e-7
e8	e-8
eT	e-t
ea	ea
eager	eager
earPath	ear-path
ebStack	eb-stack
ec	ec
echoLevel	echo-level
eclipseLocation	eclipse-location
eclipseProjectLocation	eclipse-project-location
eclipsecompiler	eclipse-compiler
ed	ed
editHandler	edit-handler
editPolicyEntry	edit-policy-entry
editing	editing
edition	edition
editions	editions
editorContext	editor-context
editorContribution	editor-contribution
editorPane	editor-pane
editorPart	editor-part
editorText	editor-text
ee	ee
ef	ef
eh	eh
ei	ei
ej	ej
ejb3Deployment	ejb3-deployment
ejb3Unit	ejb3-unit
ejbLocalRef	ejb-local-ref
ejbRef	ejb-ref
ejbReferenceName	ejb-reference-name
ek	ek
el	el
elemDef	elem-def
elemGrp	elem-grp
elemIds	elem-ids
elemToCompare	elem-to-compare
elemTypeName	elem-type-name
elementAsgnSite	element-asgn-site
elementDecls	element-decls
elementsToMove	elements-to-move
elementsToRefresh	elements-to-refresh
elemsBag	elems-bag
eliminate_dups	eliminate-dups
em	em
embeddedPkSupport	embedded-pk-support
embeddedTypes	embedded-types
embeddingContainer	embedding-container
embeddings	embeddings
emptyOK	empty-ok
empty_right_rows	empty-right-rows
emtpyListMessage	emtpy-list-message
en	en
enPeaEx	en-pea-ex
enableGnowsisSupport	enable-gnowsis-support
enable_search	enable-search
enabledChars	enabled-chars
enabledFilterIds	enabled-filter-ids
enabledIds	enabled-ids
enablements	enablements
encapsulatedException	encapsulated-exception
enclosedType	enclosed-type
enclosingClassData	enclosing-class-data
enclosingMethodParameters	enclosing-method-parameters
enclosingSize	enclosing-size
encodeURL	encode-url
encodedFragment	encoded-fragment
encodedRequest	encoded-request
encoded_keys	encoded-keys
encodingStyle	encoding-style
encryptedDoc	encrypted-doc
encryptionCode	encryption-code
encryptionScheme	encryption-scheme
endBounds	end-bounds
endDirs	end-dirs
endHour	end-hour
endIpLong	end-ip-long
endOfEmptyToken	end-of-empty-token
endPageIndex	end-page-index
endSubPath	end-sub-path
endYear	end-year
ensure_up_to_date	ensure-up-to-date
enterpriseBeanMetaData	enterprise-bean-meta-data
entityDeclIndex	entity-decl-index
entityID	entity-id
entityId	entity-id
entryByUri	entry-by-uri
entryToAdd	entry-to-add
enumConstant	enum-constant
enumConstantDeclaration	enum-constant-declaration
enumStr	enum-str
enumeratedType	enumerated-type
envInfo	env-info
environmentSupportsRedefineClasses	environment-supports-redefine-classes
eo	eo
ep	ep
eq	eq
eqCols	eq-cols
er	er
erasureIsClass	erasure-is-class
errSymbol	err-symbol
error2	error-2
errorException	error-exception
errors	errors
errorsBeginAt	errors-begin-at
errout	err-out
es	es
escSequence	esc-sequence
est_cost	est-cost
establishMsg	establish-msg
estimatedRows	estimated-rows
et	et
etext	e-text
eu	eu
ev	ev
evalCallback	eval-callback
evaluateDefault	evaluate-default
evaluatorProviders	evaluator-providers
event1	event-1
event2	event-2
eventFilter	event-filter
events	events
ew	ew
ex	ex
exactlyOne	exactly-one
excName	exc-name
exceptionInfo	exception-info
exceptionTypeName	exception-type-name
exceptionsNodeList	exceptions-node-list
exceptionsSet	exceptions-set
exclRanges	excl-ranges
excludeFilter	exclude-filter
excludeNode	exclude-node
excludedClasses	excluded-classes
excludedFiles	excluded-files
excludedSize	excluded-size
excludesList	excludes-list
exeFile	exe-file
exePath	exe-path
executors	executors
exemplar	exemplar
existResource	exist-resource
existingEmbeddedCssSections	existing-embedded-css-sections
existingIU	existing-iu
existingId	existing-id
existingNames	existing-names
existingPrefix	existing-prefix
existingType	existing-type
exitContext	exit-context
exitOnCancel	exit-on-cancel
expAffix	exp-affix
expKind	exp-kind
expLength	exp-length
expandExistingSelection	expand-existing-selection
expander_style	expander-style
expectResult	expect-result
expectedClasses	expected-classes
expectedEntries	expected-entries
expectedName	expected-name
expectedPageClass	expected-page-class
expectedRenderedPageClass	expected-rendered-page-class
expectedSampleCount	expected-sample-count
expectedSize	expected-size
expectedTimeStamp	expected-time-stamp
expenseType	expense-type
expiration	expiration
explicitDependencyMap	explicit-dependency-map
exploredPlugins	explored-plugins
exponentSize	exponent-size
exportNamePointerTable	export-name-pointer-table
exportPackageDesc	export-package-desc
exported	exported
exporter	exporter
exposeRequestAttributes	expose-request-attributes
expose_area	expose-area
expressionModel	expression-model
expressionsArray	expressions-array
expressionsObject	expressions-object
extPoint	ext-point
extPointID	ext-point-id
extendedReturnTypeDimensionEnd	extended-return-type-dimension-end
extensionPointID	extension-point-id
extensionPointId	extension-point-id
extensionType	extension-type
externalDiff	external-diff
externalTaskID	external-task-id
extraActions	extra-actions
extraAttibuteValue	extra-attibute-value
extraContext	extra-context
extraLicenseFiles	extra-license-files
exxxx	exxxx
ey	ey
f	f
f0	f-0
f1	f-1
f2	f-2
fArray1	f-array-1
fFile	f-file
fNullable	f-null-able
fO	f-o
fP	f-p
fX	f-x
fY	f-y
fa	fa
facetLabel	facet-label
factoriesToQuery	factories-to-query
failedCount	failed-count
failure_type	failure-type
fakeAttributes	fake-attributes
fakePairs	fake-pairs
fakeUid	fake-uid
fallbackToDefaultTypeMatch	fallback-to-default-type-match
falseType	false-type
fastFail	fast-fail
fatJar	fat-jar
favoredCoding	favored-coding
fb	fb
fc	fc
fd	fd
fe	fe
featureContentConsumer	feature-content-consumer
feedResolution	feed-resolution
fetchDepth	fetch-depth
fetchProfile	fetch-profile
fexcp	fexcp
ff	ff
fg	fg
fh	fh
fi	fi
fieldDecl	field-decl
fieldInfo	field-info
fieldInit	field-init
fieldModels	field-models
fieldOption	field-option
fieldPluginID	field-plugin-id
fieldSizeInStackSlots	field-size-in-stack-slots
fieldTrees	field-trees
fileComment	file-comment
fileEntry	file-entry
fileEntryIdx	file-entry-idx
fileFinder	file-finder
fileNamePatternExpr	file-name-pattern-expr
fileOrURL	file-or-url
fileOverwrite	file-overwrite
fileProcessed	file-processed
fileSystemRoot	file-system-root
file_extensions	file-extensions
filesChooserPanel	files-chooser-panel
filesToDelete	files-to-delete
filesToDownload	files-to-download
files_tobecompiled	files-to-be-compiled
fillRawSizes	fill-raw-sizes
filterClause	filter-clause
filterEmployeeId	filter-employee-id
filterMode	filter-mode
filterProperty	filter-property
filterRegexp	filter-regexp
filterTaskTypeId	filter-task-type-id
filtersList	filters-list
filtertrace	filter-trace
final_	final
findNameID	find-name-id
finder	finder
firePC	fire-pc
firstChanges	first-changes
firstNode	first-node
firstStep	first-step
firstVisibleLine	first-visible-line
firsttime	first-time
fixRelations	fix-relations
fixedDelayTasks	fixed-delay-tasks
fixedRange	fixed-range
fixlast	fix-last
fk	fk
fkinfo	fk-info
fl	fl
flatFilterString	flat-filter-string
floatNode	float-node
floatValue	float-value
flushConnPool	flush-conn-pool
flushDeletes	flush-deletes
flushEventListener	flush-event-listener
flushLog	flush-log
flyweight	flyweight
fm	fm
fn	fn
fo	fo
focusComponent	focus-component
focusableTargets	focusable-targets
foldTypes	fold-types
folderHandle	folder-handle
folderType	folder-type
follower	follower
fontIndex	font-index
fontStream	font-stream
fontStretch	font-stretch
footer	footer
footerEnd	footer-end
forDebug	for-debug
forHashCode	for-hash-code
forUpdateIndexScan	for-update-index-scan
for_file	for-file
forceThrowsClause	force-throws-clause
forecolor	forecolor
foregrounds	foregrounds
foreignKeyColumns	foreign-key-columns
foreignQualifier	foreign-qualifier
formalParameter	formal-parameter
formatStartPosition	format-start-position
formattedMsg	formatted-msg
forwardToTool	forward-to-tool
forwardTypeQualifierDataflow	forward-type-qualifier-data-flow
forwardedUrl	forwarded-url
foundReplyTo	found-reply-to
fp	fp
fq	fq
fr	fr
fracMetrics	frac-metrics
frameMs	frame-ms
frameNo	frame-no
frameStr	frame-str
frameWidth	frame-width
frameworkAdaptor	framework-adaptor
framing	framing
friendMuffinsTotalMaxSize	friend-muffins-total-max-size
from1	from-1
from2	from-2
fromGenerator	from-generator
fromInPipe	from-in-pipe
fromJavaSource	from-java-source
fromMark	from-mark
fromObj	from-obj
fromP	from-p
fromRow	from-row
fromURL	from-url
fromUri	from-uri
fromUrl	from-url
fromX	from-x
fromY	from-y
from_	from
from_loc	from-loc
from_torrent	from-torrent
fromf	from-f
froms	from-s
front	front
froot	f-root
fs	fs
ft	ft
fu	fu
fullFeature	full-feature
fullName	full-name
fullyLoaded	fully-loaded
fullyQualifiedTypeName	fully-qualified-type-name
functionCalls	function-calls
functionsList	functions-list
fv	fv
fw	fw
fx	fx
fy	fy
fz	fz
g	g
g1	g-1
g2	g-2
g3	g-3
gV	g-v
ga	ga
gameDesign	game-design
ganttChart	gantt-chart
gateST	gate-st
gb	gb
gc	gc
gd	gd
ge	ge
generateDeltas	generate-deltas
generatePackagesStructure	generate-packages-structure
generateSelection	generate-selection
generateUUID	generate-uuid
generate_NFA_dot	generate-nfa-dot
generated	generated
generatedFrom	generated-from
generatedOffset	generated-offset
generator	generator
generatorName	generator-name
generators	generators
gerApplication	ger-application
geronimoBase	geronimo-base
getCategoryFeaturesRequest	get-category-features-request
getIssuer	get-issuer
getItemRecommendationsRequest	get-item-recommendations-request
getMemberMessagesRequest	get-member-messages-request
getSellerEventsRequest	get-seller-events-request
getStorePreferencesRequest	get-store-preferences-request
gf	gf
gg	gg
givenScope	given-scope
gl	gl
glass	glass
globalColorTable	global-colortable
globalErrorsOnly	global-errors-only
globalMenuItemEnabled	global-menu-item-enabled
gm	gm
gnuVal	gnu-val
goalId	goal-id
goingToSleep	going-to-sleep
gp	gp
gr	gr
grammarClassLoader	grammar-class-loader
grammarSchoolTest	grammar-school-test
grammarTokenType	grammar-token-type
grantable	grantable
granularities	granularities
graphLayout	graph-layout
greenBits	green-bits
gridheight	grid-height
groovyKeyword	groovy-keyword
groupChars	group-chars
groupItem	group-item
groupStruct	group-struct
gs	gs
gssupType	gssup-type
gt	gt
gu	gu
guessing	guessing
gv	gv
gw	gw
gx	gx
gy	gy
h	h
h1	h-1
h2	h-2
hInternet	h-internet
hMenu	h-menu
hNamedPipe	h-named-pipe
hVisible	h-visible
haPartitionDependencyCreator	ha-partition-dependency-creator
hadChockPing	had-chock-ping
hadPreviousInput	had-previous-input
halted	halted
handlerAttributeName	handler-attribute-name
handlerChainName	handler-chain-name
handlerFO	handler-fo
handlerForInitBinderCall	handler-for-init-binder-call
handlerId	handler-id
handlerPC	handler-pc
handlerPc	handler-pc
handlerSource	handler-source
handler_id	handler-id
handler_pc	handler-pc
handlersPropertyName	handlers-property-name
hasAlpha	has-alpha
hasBindingAttrList	has-binding-attr-list
hasConstructorTypeParameters	has-constructor-type-parameters
hasDirtyCollection	has-dirty-collection
hasDistinctAggregate	has-distinct-aggregate
hasExceptionHandlers	has-exception-handlers
hasFlushSpecList	has-flush-spec-list
hasImageSelector	has-image-selector
hasLaunchers	has-launchers
hasPotentialMatches	has-potential-matches
hasPrimary	has-primary
hasPrivateChanges	has-private-changes
hasPublicChanges	has-public-changes
hasTasksSelected	has-tasks-selected
hasalpha	has-alpha
hasfocus	has-focus
hashChars	hash-chars
hb	hb
hbModelJoins	hb-model-joins
hc	hc
hd	hd
he	he
headerGetter	header-getter
headerRange	header-range
header_size	header-size
helpID	help-id
helpId	help-id
helpProvider	help-provider
helper	helper
hfgColor	hfg-color
hg	hg
hgConfigFiles	hg-config-files
hh	hh
hi	hi
hierarchy	hierarchy
highlihgtings	highlihgtings
highval	highval
hintAntialiasing	hint-antialiasing
historyFilePath	history-file-path
hl	hl
hm	hm
ho	ho
holderPresent	holder-present
holiday	holiday
homeBase	home-base
homeHandle	home-handle
homeMethods	home-methods
hookRegistry	hook-registry
hook_data	hook-data
horizontalAlignment	horizontal-alignment
horizontalAxis	horizontal-axis
horizontalGap	horizontal-gap
horizontalScrollBar	horizontal-scroll-bar
hp	hp
hq	hq
hqlClassName	hql-class-name
hr	hr
hrefUrl	href-url
hs	hs
ht	ht
htmlContent	html-content
htmlContext	html-context
httpEquiv	http-equiv
httpMethod	http-method
huffClass	huff-class
hw	hw
i	i
i0	i-0
i1	i-1
i2	i-2
iControl	i-control
iDispatch	i-dispatch
iE	i-e
iF	i-f
iMaxWidth	i-max-width
iValue	i-value
ia	ia
ib	ib
ic	ic
iconSize	icon-size
id	id
idUniqueness	id-uniqueness
identifierGeneratorStrategy	identifier-generator-strategy
identityService	identity-service
idleTimeoutSecs	idle-timeout-secs
idref	id-ref
ie	ie
ifStatement	if-statement
ifield	i-field
ignoreContents	ignore-contents
ignoreFiles	ignore-files
ignoreLowerCaseNames	ignore-lower-case-names
ignoreMethodNF	ignore-method-nf
ignoreNullExpressions	ignore-null-expressions
ignoreOcsp	ignore-ocsp
ignoreReponseCode	ignore-reponse-code
ignoreResourceNotFound	ignore-resource-not-found
ignoreSavedVersions	ignore-saved-versions
ih	ih
ii	ii
iicount	ii-count
ik	ik
il	il
ilocal	i-local
im	im
imageFilePath	image-file-path
imageName	image-name
imageRect	image-rect
imageResourceInfo	image-resource-info
immediateLoad	immediate-load
impType	imp-type
implementingClass	implementing-class
implicitTypeReference	implicit-type-reference
importOrder	import-order
importRef	import-ref
importRewrite	import-rewrite
importRoot	import-root
importStatic	import-static
importsResolved	imports-resolved
in	in
inArgs	in-args
inAspect	in-aspect
inDefaultEventSet	in-default-event-set
inError	in-error
inFile	in-file
inFunctionParams	in-function-params
inMainClass	in-main-class
inMessage	in-message
inModuleFolder	in-module-folder
inNewProject	in-new-project
inRaster	in-raster
inRule	in-rule
in_dsBean	in-ds-bean
in_sort_order	in-sort-order
inactiveFilter	inactive-filter
inc1	inc-1
inc2	inc-2
incPrjName	inc-prj-name
incl	incl
includeButSearch	include-but-search
includeClasses	include-classes
includeDeprecated	include-deprecated
includeDirectories	include-directories
includeEager	include-eager
includeFields	include-fields
includeHandler	include-handler
includeMethods	include-methods
includeNames	include-names
includePattern	include-pattern
includeScroll	include-scroll
includeUpperBound	include-upper-bound
includedPackages	included-packages
includesList	includes-list
includingChildren	including-children
incr	incr
increments	increments
indentChars	indent-chars
indentMap	indent-map
indexArg	index-arg
indexC2B	index-c2b
indexCID	index-cid
indexCollectionSelectorParamSpec	index-collection-selector-param-spec
indexIdData	index-id-data
indexInUnfilteredList	index-in-unfiltered-list
indexListener	index-listener
indexOfDiff	index-of-diff
indexOrElement	index-or-element
indexPath	index-path
indexSuffix	index-suffix
indexType	index-type
index_conglomid	index-conglomid
indirectBinding	indirect-binding
indx	indx
inet	inet
inex	inex
infc	infc
infe	infe
infl	infl
info	info
infoCenterName	info-center-name
inherit_handles	inherit-handles
inheritanceState	inheritance-state
inherits	inherits
init	init
initAction_	init-action
initLayoutCode	init-layout-code
initPubKey	init-pub-key
init_sem	init-sem
initialEnabled	initial-enabled
initialReconcile	initial-reconcile
initialRequest	initial-request
initialString	initial-string
initialX	initial-x
initialY	initial-y
initializedFields	initialized-fields
initializerSorter	initializer-sorter
initials	initials
initiate	initiate
initiatorId	initiator-id
injecting	injecting
inlinetext	inline-text
inplace	in-place
inputElements	input-elements
inputLineCount	input-line-count
inputLocale	input-locale
inputReader	input-reader
input_properties	input-properties
inscopeNamespace	in-scope-namespace
inse	inse
insertBytes	insert-bytes
insertPosition	insert-position
insertedTextLength	inserted-text-length
inside	inside
insideTypeAnnotation	inside-type-annotation
insn	insn
insp	insp
inspTabs	insp-tabs
inst	inst
instExtInfo	inst-ext-info
instIncarnation	inst-incarnation
installDirectory	install-directory
instanceInitBlock	instance-init-block
instanceTypes	instance-types
instantiate	instantiate
instantiatingType	instantiating-type
int0	int-0
int1	int-1
int2	int-2
int3	int-3
int4	int-4
int5	int-5
intLen	int-len
inte	inte
integerClass	integer-class
interceptPage	intercept-page
interceptorConfig	interceptor-config
interfaes	interfaes
interfase	interfase
interfaze	interfaze
interim_save	interim-save
internalHeight	internal-height
internalTableField	internal-table-field
intf	intf
into	into
intp	intp
intr	intr
ints	ints
invalidMessage	invalid-message
invk	invk
invocationOptions	invocation-options
io	io
ioE1	io-e1
ioEx	io-ex
iobe	iobe
iobj	iobj
iortemp	iortemp
ip	ip
ir	ir
irTP	irtp
irde	irde
iref	iref
irex	irex
irgs	irgs
irie	irie
irse	irse
is	is
is19	is-19
is64	is-64
isArchetypeNg	is-archetyp-eng
isAssignmentOperator	is-assignment-operator
isBoolean	is-boolean
isBuiltin	is-builtin
isBundleStatic	is-bundle-static
isCP	is-cp
isCanWrite	is-can-write
isCascadeDeleteEnabled	is-cascade-delete-enabled
isComposite	is-composite
isConstraint	is-constraint
isCopyOnSelect	is-copy-on-select
isCritical	is-critical
isCrossContext	is-cross-context
isDC	is-dc
isDefaultRefName	is-default-ref-name
isDirty	is-dirty
isEmptyKenaiProject	is-empty-kenai-project
isEq	is-eq
isEx	is-ex
isFindUsages	is-find-usages
isFullMode	is-full-mode
isID	is-id
isId	is-id
isIgnoreCellBackground	is-ignore-cell-background
isIn	is-in
isIndexAccessed	is-index-accessed
isIndexed	is-indexed
isInnerBean	is-inner-bean
isIs	is-is
isJUnit4	is-j-unit4
isJs	is-js
isJsr109Platform	is-jsr109-platform
isKindOfUsed	is-kind-of-used
isLocked	is-locked
isMine	is-mine
isMove	is-move
isNested	is-nested
isOn	is-on
isOneByDefault	is-one-by-default
isOptimizedFalse	is-optimized-false
isOr	is-or
isPE	is-pe
isPk	is-pk
isPropertiesName	is-properties-name
isQuickSearch	is-quick-search
isRT	is-rt
isReadOnlyInitialized	is-read-only-initialized
isRegEx	is-reg-ex
isRegex	is-regex
isRelative	is-relative
isRollbackAllowed	is-rollback-allowed
isShrinkToFit	is-shrink-to-fit
isStateMask	is-state-mask
isStub	is-stub
isSuiteComponentWizard	is-suite-component-wizard
isSuperPom	is-super-pom
isTV	is-tv
isTransient	is-transient
isTrayIconWindow	is-tray-icon-window
isUI	is-ui
isVersioned	is-versioned
isWildCardInsert	is-wild-card-insert
isWriteable	is-writeable
isXA	is-xa
is_public	is-public
isaa	isaa
isbn	isbn
iseq	iseq
isex	isex
isfe	isfe
isfill	is-fill
isolated	isolated
iste	iste
istr	istr
it	it
itFO	itfo
ite2	ite-2
item	item
itemHyperlinks	item-hyperlinks
itemIndex	item-index
itemIsNotOptional	item-is-not-optional
itemName	item-name
itemsDeleted	items-deleted
iter	iter
iterableType	iterable-type
iterateDirectories	iterate-directories
itex	itex
itfe	itfe
itm1	itm-1
itm2	itm-2
itms	itms
itor	itor
itse	itse
iu	iu
iuID	iu-id
iuId	iu-id
iv	iv
iw	iw
ix	ix
iy	iy
j	j
j1	j1
j2	j2
j2eeSpecVersion	j2ee-spec-version
j2eeSpecVersionModelObject	j2ee-spec-version-model-object
ja	ja
jadFileData	jad-file-data
jarExtension	jar-extension
jarFileLoc	jar-file-loc
jarStream	jar-stream
jarSuffix	jar-suffix
jardesc	jar-desc
jasperPrint	jasper-print
java2jsMap	java-2-js-map
javaElementDestination	java-element-destination
javaModule	java-module
javaName	java-name
javaProjectToInit	java-project-to-init
javaSignature	java-signature
javaSrcFiles	java-src-files
javaStr	java-str
javaTypeParameter	java-type-parameter
javaVMs	java-vms
java_class_object	java-class-object
javacErrors	javac-errors
jaxrpcMappingPath	jaxrpc-mapping-path
jc	jc
jd	jd
jdbcQueryMetaData	jdbc-query-meta-data
jdbcTemplate	jdbc-template
jdocFolders	jdoc-folders
jdtValue	jdt-value
je	je
jf	jf
jh	jh
ji	ji
jk	jk
jl	jl
jm	jm
jmpTarget	jmp-target
jmxServerConnection	jmx-server-connection
jn	jn
jndiPath	jndi-path
jndiServiceName	jndi-service-name
jndiae	jndi-ae
jnlpString	jnlp-string
jo	jo
jobClass	job-class
jobsSelected	jobs-selected
joinStrategies	join-strategies
jp	jp
jr	jr
js	js
jshortSize	jshort-size
jsoSuperTypes	jso-super-types
jsonRequestString	json-request-string
jspProperty	jsp-property
jspReader	jsp-reader
jt	jt
jtaDataSource	jta-data-source
jumpToken	jump-token
justDrop	just-drop
jv	jv
jw	jw
k	k
k1	k-1
k2	k-2
k3	k-3
k4	k-4
k5	k-5
kInOut	k-in-out
k_	k
ka	ka
kb	kb
kc	kc
ke	ke
keepDeleted	keep-deleted
keepDocComments	keep-doc-comments
keepOriginal	keep-original
kenai	kenai
keyCountHint	key-count-hint
keyEventInterceptor	key-event-interceptor
keyGenSpi	key-gen-spi
keySize	key-size
keyWords	key-words
key_val	key-val
keyoffset	key-offset
keystoreName	keystore-name
keystroke_set	keystroke-set
keysym_uppercase	keysym-uppercase
keywordsString	keywords-string
kf	kf
kg	kg
ki	ki
kindHint	kind-hint
kindType	kind-type
kk	kk
kl	kl
km	km
kn	kn
knownTypes	known-types
kp	kp
kr	kr
ks	ks
kt	kt
kv	kv
kw	kw
kx	kx
l	l
l1	l-1
l2	l-2
la	la
labelElement	label-element
labelProvider2	label-provider-2
labelText	label-text
labelsArray	labels-array
lafCondition	laf-condition
langMapping	lang-mapping
languageFile	language-file
larger	larger
lastAccessTime	last-access-time
lastBarPaint	last-bar-paint
lastDateTextUpdate	last-date-text-update
lastDocCollected	last-doc-collected
lastHeader	last-header
lastInRule	last-in-rule
lastInsertion	last-insertion
lastLogFileToBackup	last-log-file-to-backup
lastModifiedAfter	last-modified-after
lastPrintable	last-printable
lastSuccessful	last-successful
lastTokenOffset	last-token-offset
last_updated	last-updated
lastname	last-name
lateTypeMungers	late-type-mungers
latestVersion	latest-version
latest_file_name	latest-file-name
launchConfig	launch-config
layoutBar	layout-bar
layoutClass	layout-class
layoutExp	layout-exp
layoutName	layout-name
lazyInitHandlers	lazy-init-handlers
lazy_haves	lazy-haves
lb	lb
lc	lc
lcToken	lc-token
ld	ld
le	le
leadingSegmentsToRemove	leading-segments-to-remove
leastSigBits	least-sig-bits
leftElement	left-element
leftsib	left-sib
legalOptions	legal-options
legalValues	legal-values
legendSettings	legend-settings
lengthArg	length-arg
lengthRequiringScldta	length-requiring-scldta
lengthToTest	length-to-test
levelSpan	level-span
levelingDelayFormat	leveling-delay-format
lexical	lexical
lexicalAnalysis	lexical-analysis
lexicalPosition	lexical-position
lf	lf
lg	lg
lh	lh
li	li
libraryElement	library-element
libsDirPath	libs-dir-path
licenseOptions	license-options
lifecycleResults	lifecycle-results
lineBalance	line-balance
lineBreak	line-break
lineHandler	line-handler
lineHeightUnit	line-height-unit
lineMap	line-map
lineNum	line-num
lineNumStorage	line-num-storage
lineObj	line-obj
linePen	line-pen
linePos	line-pos
lineStepExec	line-step-exec
lineStyleEnum	line-style-enum
line_number	line-number
linesPerPage	lines-per-page
linkTargetStore	link-target-store
linkedNodeView	linked-node-view
linkerName	linker-name
listDataListener	list-data-listener
listFileArgs	list-file-args
listIterator	list-iterator
listOfContactInfos	list-of-contact-infos
listOperator	list-operator
listUIBean	list-ui-bean
list_in	list-in
listenerInfo	listener-info
listenerMethod	listener-method
ll	ll
lm	lm
ln	ln
lo	lo
loadMap	load-map
loadQueryInfluencers	load-query-influencers
loaded	loaded
loader	loader
localAW	local-aw
localAttrName	local-attr-name
localFeatureReference	local-feature-reference
localFileObject	local-file-object
localGetter	local-getter
localIDKey	local-id-key
localId	local-id
localImage	local-image
localNo	local-no
localPW	local-pw
localPt	local-pt
localSettings	local-settings
localTime	local-time
localTx	local-tx
localWorkers	local-workers
localeFinder	locale-finder
locales	locales
localid	local-id
localizationFile	localization-file
locationArg	location-arg
locationHints	location-hints
locationWhereDoomedValueIsObserved	location-where-doomed-value-is-observed
lockFileName	lock-file-name
lockHeld	lock-held
lockList	lock-list
lockNumber	lock-number
lockTree	lock-tree
lock_template	lock-template
locking	locking
log4jResource	log4j-resource
logAlert	log-alert
logMsgFormat	log-msg-format
logPath	log-path
log_warnings	log-warnings
logger_name	logger-name
logicalNameToClassName	logical-name-to-class-name
logicalScreenWidth	logical-screen-width
longBytes	long-bytes
longDescription	long-description
longRect	long-rect
lookupCtx	lookup-ctx
loopLabel	loop-label
lowValue	low-value
lowerLeft	lower-left
lowerLimit	lower-limit
lp	lp
lpath	l-path
lr	lr
ls	ls
lu	lu
lv	lv
lw	lw
lx	lx
ly	ly
m	m
m0	m-0
m1	m-1
m2	m-2
m3	m-3
m4	m-4
mCols	m-cols
mE	m-e
mElement	m-element
mP	m-p
mW	m-w
mX	m-x
mY	m-y
ma	ma
macroExpander	macro-expander
mainConstraints	main-constraints
majorAxisSpan	major-axis-span
makeList	make-list
managementInterface	management-interface
managerClass	manager-class
mangled_name	mangled-name
manifestRoot	manifest-root
manual	manual
manyToManyOwnerSideEntityName	many-to-many-owners-ide-entity-name
mapArray	map-array
mapData	map-data
mapFile	map-file
mappedByPropertyName	mapped-by-property-name
mappingData	mapping-data
margin	margin
markerDeltas	marker-deltas
marshal	marshal
matchLength	match-length
matchSpec	match-spec
matchingIdRuleName	matching-id-rule-name
matchingMember	matching-member
maxAmount	max-amount
maxBuffer	max-buffer
maxColomns	max-colomns
maxDoc	max-doc
maxLayer	max-layer
maxPixelCount	max-pixel-count
maxRecords	max-records
maxSeekAheadSecs	max-seek-ahead-secs
maxSkipLevels	max-skip-levels
maxSmallSegments	max-small-segments
max_fails_for_live	max-fails-for-live
max_lines	max-lines
maxblkext	max-blk-ext
maximumDigits	maximum-digits
mayBeImprecise	may-be-imprecise
mb	mb
mbServerConnection	mb-server-connection
mc	mc
mcfProps	mcf-props
md	md
mddRequired	mdd-required
me	me
memberLineNumber	member-line-number
menuContainerType	menu-container-type
menuItemGap	menu-item-gap
menuNameKey	menu-name-key
menuTree	menu-tree
menu_item	menu-item
menushell	menu-shell
mercuryColor	mercury-color
mergeFactor	merge-factor
message1	message-1
message2	message-2
messageAlignment	message-alignment
messageExpression	message-expression
messageSource	message-source
messageTemplates	message-templates
messager	messager
messages	messages
metaAnnotationType	meta-annotation-type
metaType	meta-type
metatypeName	meta-type-name
methodAnalysisEngine	method-analysis-engine
methodArity	method-arity
methodClassType	method-class-type
methodLists	method-lists
methodTable	method-table
methodToOverride	method-to-override
metricID	metric-id
mf	mf
mg	mg
mh	mh
mi	mi
mimeType1	mime-type-1
mimeType2	mime-type-2
mimeTypes	mime-types
minCoord	min-coord
minCount	min-count
minLat	min-lat
minLen	min-len
minLength	min-length
minLevel_	min-level
minLon	min-lon
minPad	min-pad
minPathLength	min-path-length
minPercentage	min-percentage
minPos	min-pos
minSize	min-size
min_bits	min-bits
min_overheads	min-overheads
min_rate	min-rate
min_value	min-value
minargs	min-args
minimise	minimise
minimize	minimize
minutesSeconds	minutes-seconds
missingActions	missing-actions
missingTypeNames	missing-type-names
mixTypes	mix-types
mixedMode	mixed-mode
mj	mj
ml	ml
mm	mm
mmods	mmods
mn	mn
mnemonicHandle	mnemonic-handle
mneumonic	mneumonic
mo	mo
mobileDeviceResumeEventSourceComponent	mobile-device-resume-event-source-component
modBits	mod-bits
modeView	mode-view
modelEvent	model-event
modelLength	model-length
modelObservableSet	model-observable-set
modelsListenersAddedTo	models-listeners-added-to
modifications	modifications
modifiedElements	modified-elements
modifiedSourceEntries	modified-source-entries
moduleConfig	module-config
moduleDataSources	module-data-sources
moduleDependencies	module-dependencies
moduleDestinations	module-destinations
moduleProject	module-project
moduleServiceName	module-service-name
monitor	monitor
monitor_num	monitor-num
monitorableTm	monitorable-tm
monthSelector	month-selector
mouseListener	mouse-listener
mouseMotionL	mouse-motion-l
mouseevent	mouse-event
moveDownLabel	move-down-label
moveOffset	move-offset
moveResources	move-resources
moveSAN	move-san
moveWithShell	move-with-shell
movedTargetDefinitions	moved-target-definitions
movingEdges	moving-edges
movingWidget	moving-widget
mp	mp
mpHandler	mp-handler
mpParams	mp-params
mpxjDay	mpxj-day
mr	mr
mresp	mresp
mrex	mrex
ms	ms
msEpr	ms-epr
msgProp	msg-prop
msnList	msn-list
mt	mt
mu	mu
mue1	mue-1
mue2	mue-2
muee	muee
muex	muex
mufe	mufe
mult	mult
multiSel	multi-sel
mungerLoc	munger-loc
must	must
mute	mute
mv	mv
mvtc	mvtc
mw	mw
mx	mx
my	my
myAcceptableStart	my-acceptable-start
myID	my-id
myId	my-id
myLock	my-lock
myPK	my-pk
myWeekEndColor	my-weekend-color
myindex	my-index
n	n
n1	n-1
n2	n-2
nNumberOfBytesToRead	n-number-of-bytes-to-read
nObjAndAge	n-obj-and-age
nS	n-s
nUserThreads	n-user-threads
n_	n
na	na
nameChanged	name-changed
nameFromAttribute	name-from-attribute
nameSize	name-size
nameToIdMap	name-to-id-map
namedImportScope	named-import-scope
namesOnly	names-only
namespaceName	namespace-name
namespacepermission	namespace-permission
namingException	naming-exception
nat_adapter	nat-adapter
nat_pmp_device	nat-pmp-device
nativeCodeSet	native-code-set
naturalSort	natural-sort
navigatorContentService	navigator-content-service
navigatorLanguage	navigator-language
nb	nb
nbWanted	nb-wanted
nbproj	nb-proj
nc	nc
ncapacity	n-capacity
nd	nd
ne	ne
needQualification	need-qualification
needTwo	need-two
negateCR	negate-cr
nestedPath	nested-path
netResultSet	net-result-set
netif	net-if
newAExp	new-a-exp
newActiveEditor	new-active-editor
newAt	new-at
newBd	new-bd
newBlockingTimeout	new-blocking-timeout
newCM	new-cm
newChains	new-chains
newConstructorDecl	new-constructor-decl
newCu	new-cu
newDD	new-dd
newDMState	new-dm-state
newDN	new-dn
newDe	new-de
newDefined	new-defined
newDelay	new-delay
newDelta	new-delta
newDirty	new-dirty
newDo	new-do
newEd	new-ed
newEl	new-el
newEm	new-em
newEnd	new-end
newEndNode	new-end-node
newEnv	new-env
newEx	new-ex
newExt	new-ext
newField	new-field
newFqn	new-fqn
newGC	new-gc
newGe	new-ge
newGrammar	new-grammar
newGuy	new-guy
newHandlerName	new-handler-name
newHi	new-hi
newID	new-id
newIO	new-io
newIOR	new-ior
newIS	new-is
newId	new-id
newIdentity	new-identity
newIh	new-ih
newImage	new-image
newIn	new-in
newJaxWs	new-jaxws
newJs	new-js
newKey	new-key
newKm	new-km
newLen	new-len
newLhs	new-lhs
newLoc	new-loc
newLow	new-low
newMap	new-map
newMatch	new-match
newMax	new-max
newMc	new-mc
newMedium	new-medium
newMethods	new-methods
newName	new-name
newObjectSpaceEnabled	new-object-space-enabled
newOffset	new-offset
newPI	new-pi
newParagraph	new-paragraph
newPk	new-pk
newPredicate	new-predicate
newProject	new-project
newPublicId	new-public-id
newPv	new-pv
newQueryList	new-query-list
newReferencedEntries	new-referenced-entries
newReplicants	new-replicants
newReportOnModule	new-report-on-module
newRule	new-rule
newSL	new-sl
newSR	new-sr
newSl	new-sl
newSt	new-st
newTX	new-tx
newTasks	new-tasks
newTexts	new-texts
newToolTip	new-tool-tip
newUI	new-ui
newVT	new-vt
newView	new-view
newVm	new-vm
newWs	new-ws
new_category	new-category
new_color	new-color
new_dir	new-dir
new_highest_page	new-highest-page
new_image	new-image
newbranchrow	new-branch-row
newcm	new-cm
newer	newer
newfd	new-fd
newlyUnprofiledClasses	newly-unprofiled-classes
newpc	new-pc
newwd	new-wd
nextIFDOffset	next-ifd-offset
nextLine	next-line
nextLink	next-link
nextTime	next-time
nf	nf
ng	ng
nh	nh
ni	ni
nitems_return	nitems-return
nj	nj
nk	nk
nl	nl
nlsSubstitutions	nls-substitutions
nm	nm
nn	nn
no	no
noAttachments	no-attachments
noBookTitle	no-book-title
noOfColumns	no-of-columns
noStatic	no-static
noSuchMethodException	no-such-method-exception
no_input_rows	no-input-rows
nodeActionProvider	node-action-provider
nodeArray	node-array
nodeDescriptor	node-descriptor
node_id	node-id
nodename	node-name
nodeprecated	no-deprecated
nodesToCategoriesMap	nodes-to-categories-map
nonExpiring	non-expiring
nonHosts	non-hosts
nonPublicAccessAllowed	non-public-access-allowed
normalizedJulianYear	normalized-julian-year
notBeforeTime	not-before-time
notDeletedMembersInSubtypes	not-deleted-members-in-subtypes
notRunModuleProgram	not-run-module-program
notUsed	not-used
noteText	note-text
nothing	nothing
notificationInfo	notification-info
notifyDescriptor	notify-descriptor
np	np
nr	nr
ns	ns
nsPrefix	ns-prefix
nt	nt
ntargets	n-targets
ntype	n-type
nu	nu
nullArgSet	null-arg-set
nullAsEmptyMap	null-as-empty-map
numClasses	num-classes
numPages	num-pages
numQueries	num-queries
numScans	num-scans
numSlots	num-slots
numUnfilledPages	num-unfilled-pages
numUnique	num-unique
num_ranges	num-ranges
numberOfChanges	number-of-changes
numberOfChars	number-of-chars
numbuffers	num-buffers
nv	nv
nx	nx
ny	ny
o	o
o0	o-0
o1	o-1
o2	o-2
o3	o-3
o4	o-4
o5	o-5
o6	o-6
o7	o-7
o8	o-8
o9	o-9
oS	o-s
oa	oa
ob	ob
objID	obj-id
objId	obj-id
objIn	obj-in
objNs	obj-ns
objTo	obj-to
objectClassNames	object-class-names
objectID	object-id
objectId	object-id
objectMapper	object-mapper
objectName	object-name
objectRead	object-read
object_type	object-type
objects1	objects-1
objects2	objects-2
objectspace	object-space
obligationType	obligation-type
obrName	obr-name
oc	oc
occurringPatterns	occurring-patterns
oclConstraint	ocl-constraint
octetBufferListener	octet-buffer-listener
od	od
oe	oe
of	of
offsetBefore	offset-before
offsetInLine	offset-in-line
oflag	oflag
oformat	o-format
oglyphs	o-glyphs
oi	oi
oidMap	oid-map
ok	ok
okCancelButtons	ok-cancel-buttons
ol	ol
oldChainedEntriesMap	old-chained-entries-map
oldContextClassLoader	old-context-class-loader
oldFlags	old-flags
oldLogName	old-log-name
oldPadding	old-padding
oldProvider	old-provider
oldRepos	old-repos
oldServInstID	old-serv-inst-id
oldSide	old-side
oldSite	old-site
oldSize	old-size
oldSourceNode	old-source-node
old_row	old-row
old_url	old-url
om	om
omitNorms	omit-norms
on	on
onClickLinkClickCount	on-click-link-click-count
onLeft	on-left
onValueChangedPublishTopic	on-value-changed-publish-topic
onlyOneTask	only-one-task
only_if_exists	only-if-exists
oo	oo
oopAddr	oop-addr
oopMap	oop-map
op	op
openConstructors	open-constructors
openReadOnly	open-read-only
openToken	open-token
openedFiles	opened-files
operationEvent	operation-event
operator	operator
oppositeDir	opposite-dir
optArgsCount	opt-args-count
optimalUnits	optimal-units
optimize	optimize
optionalEnv	optional-env
optionalKey	optional-key
optionalObjectId	optional-object-id
optionalOutputFile	optional-output-file
options	options
optionsFile	options-file
optionsFileName	options-file-name
optionsOper	options-oper
optionsService	options-service
optionsStartToken	options-start-token
or	or
orderPosition	order-position
orderedPropValues	ordered-prop-values
orderedTerms	ordered-terms
ordinalDescriptors	ordinal-descriptors
organization	organization
organizer	organizer
origCodes	orig-codes
origFromListSize	orig-from-list-size
origToken	orig-token
original2imported	original-2-imported
originalBackgroundColor	original-background-color
originalCell	original-cell
originalCollection	original-collection
originalCurrentSchema	original-current-schema
originalEndOffset	original-end-offset
originalTreeNode	original-tree-node
originalURL	original-url
originalUrl	original-url
original_file_name	original-file-name
originialReport	originial-report
origionalFile	origional-file
origrect	orig-rect
orphans	orphans
os	os
osConform	os-conform
os_2Table	os-2-table
ot	ot
otherIndex	other-index
otherMethod	other-method
other_object	other-object
ou	ou
outChannel	out-channel
outEdges	out-edges
outItems	out-items
outScope	out-scope
outToken	out-token
outputCS	output-cs
outputListener	output-listener
outputMessages	output-messages
outputProp	output-prop
outputStartLine	output-start-line
outputWrapperName	output-wrapper-name
outsideBorder	outside-border
ov	ov
overrideValue	override-value
override_location	override-location
overridingProperty	overriding-property
ow	ow
owner	owner
ownerX	owner-x
ownerY	owner-y
owners	owners
owning	owning
owningEntityName	owning-entity-name
owningStmt	owning-stmt
ox	ox
oy	oy
p	p
p0	p-0
p1	p-1
p2	p-2
p3	p-3
p5	p-5
pAddedChild	p-added-child
pB	p-b
pCause	p-cause
pChange	p-change
pE	p-e
pError	p-error
pG	p-g
pI	p-i
pInput	p-input
pMetaData	p-meta-data
pNumberOfCalls	p-number-of-calls
pPosition	p-position
pSender	p-sender
pSessions	p-sessions
pSignatures	p-signatures
pT	p-t
pToTarget	p-to-target
pWrappedKey	p-wrapped-key
p_includeFragment	p-include-fragment
p_userinfo	p-user-info
pa	pa
pack_type	pack-type
packageAdmin	package-admin
packageConfigs	package-configs
packageExplorer	package-explorer
packageLocators	package-locators
packageNamePart	package-name-part
packagePrefix	package-prefix
packagelistLoc	package-list-loc
packagesInProfile	packages-in-profile
packedData	packed-data
paddLines	padd-lines
paddingBuffer	padding-buffer
pageNumber	page-number
pageWindowInternal	page-window-internal
paintDiff	paint-diff
paintingChild	painting-child
paintingComponent	painting-component
paneOrientation	pane-orientation
paramNames	param-names
paramOffset	param-offset
paramPasswd	param-passwd
paramSourceRefs	param-source-refs
paramTags	param-tags
parameterPackageNames	parameter-package-names
parameterValuesByName	parameter-values-by-name
parameterdes	parameter-des
parameterizedDeclaringClass	parameterized-declaring-class
parameterizedSingleTypeReference	parameterized-single-type-reference
parametersForNextRequest	parameters-for-next-request
paramsElement	params-element
paramsMap	params-map
parentBeanFactory	parent-bean-factory
parentCodeBase	parent-code-base
parentConfigurations	parent-configurations
parentContext	parent-context
parentCookie	parent-cookie
parentDelta	parent-delta
parentDepN	parent-dep-n
parentElements	parent-elements
parentImpl	parent-impl
parentStack	parent-stack
parentState	parent-state
parent_page	parent-page
parentsPath	parents-path
parmTypeNames	parm-type-names
parmtypes	parm-types
parseChar	parse-char
parseException	parse-exception
parsePosition	parse-position
parseSuccessful	parse-successful
parserContext	parser-context
parserFactoryClassNames	parser-factory-class-names
partPainter	part-painter
partialSetterCode	partial-setter-code
partyAInfo	party-a-info
passIndex	pass-index
passTest	pass-test
passivationMinIdleTime	passivation-min-idle-time
patEnd	pat-end
patchButton	patch-button
patchFile	patch-file
pathCallback	path-callback
pathItems	path-items
patternIdx	pattern-idx
patternsList	patterns-list
pb	pb
pc	pc
pd	pd
pdwFlags	pdw-flags
pe	pe
pe_peer	pe-peer
peer_id_client	peer-id-client
peer_identity	peer-identity
pendingCookies	pending-cookies
performIncSearch	perform-inc-search
performanceConnectionTime	performance-connection-time
performanceReportOn	performance-report-on
persistName	persist-name
persistenceUnitTransactionType	persistence-unit-transaction-type
personManager	person-manager
pf	pf
pg	pg
ph	ph
phoneNumber	phone-number
phoneNumberLabel	phone-number-label
pi	pi
pi_for_update	pi-for-update
pieceFollowsCursor	piece-follows-cursor
pieceImages	piece-images
piece_max_size	piece-max-size
pj	pj
pk	pk
pkcs7Length	pkcs7-length
pkgFragments	pkg-fragments
pl	pl
placeOnNewLine	place-on-new-line
placeTokenizerType	place-tokenizer-type
plannerProject	planner-project
plannerResource	planner-resource
platformArch	platform-arch
platformArgs	platform-args
platformNameToSelect	platform-name-to-select
platformPropName	platform-prop-name
playable	playable
plug_msg	plug-msg
pluginIdentifier	plugin-identifier
pluginRepo	plugin-repo
pm	pm
pmonitor	p-monitor
pn	pn
po	po
pointOfAttachment	point-of-attachment
pomLocation	pom-location
poolSize	pool-size
popularity	popularity
populateDependencies	populate-dependencies
portLocations	port-locations
posChange	pos-change
posUnadjusted	pos-unadjusted
positionSpecifiedInPluginDescriptor	position-specified-in-plugin-descriptor
positionsCombo	positions-combo
possibleResults	possible-results
possibleTargetIDs	possible-target-ids
postData	post-data
postUpdateEventListener	post-update-event-listener
postValues	post-values
potentialChild	potential-child
pp	pp
pq	pq
pr	pr
precedingItemName	preceding-item-name
predCtr	pred-ctr
predaxis	pred-axis
prefferedSize	preffered-size
prefixAndSuffixRelevance	prefix-and-suffix-relevance
prefixURIPairs	prefix-uri-pairs
prefixedQNameValAllowed	prefixed-q-name-val-allowed
prefixesMap	prefixes-map
preload	preload
preprocessorLineList	preprocessor-line-list
preserveAllLocals	preserve-all-locals
preservePermissions	preserve-permissions
pressTime	press-time
prevNC	prev-nc
prevSuffix	prev-suffix
prev_pc	prev-pc
previewAllEvents	preview-all-events
previewMessage	preview-message
previousEdition	previous-edition
previousLine	previous-line
previousPanel	previous-panel
previousPluginPath	previous-plugin-path
previousStates	previous-states
previousStyle	previous-style
primTypeID	prim-type-id
primitiveKey	primitive-key
printArea	print-area
printSubcategories	print-subcategories
printText	print-text
prioritisedFavouriteCartoonCharacters	prioritised-favourite-cartoon-characters
privateUsage	private-usage
privilege	privilege
prmList	prm-list
procedureNamePattern	procedure-name-pattern
processingEvents	processing-events
producerPID	producer-pid
productionMode	production-mode
profileFiles	profile-files
profileServer	profile-server
profileXmlRepo	profile-xml-repo
progressPercent	progress-percent
progressTitle	progress-title
projDir	proj-dir
projRootFo	proj-root-fo
projectHelper	project-helper
projectIds	project-ids
projectKey	project-key
projectMap	project-map
projectNameOut	project-name-out
projectsToBeAdded	projects-to-be-added
propName	prop-name
propNodes	prop-nodes
propTableModel	prop-table-model
propagationBehavior	propagation-behavior
propertiesArray	properties-array
propertiesNames	properties-names
property	property
propertyAccessors	property-accessors
propertyIndex	property-index
propertyInfo	property-info
propertyNamePrefix	property-name-prefix
properytName	properyt-name
protectedCode	protected-code
protocolString	protocol-string
providedExports	provided-exports
provisioningContext	provisioning-context
proxiedObject	proxied-object
proxiesEnabled	proxies-enabled
proxyContext	proxy-context
proxyFamilyName	proxy-family-name
proxyInterface	proxy-interface
ps	ps
pseudoTests	pseudo-tests
pt	pt
pu	pu
pushable	pushable
pushed	pushed
pv	pv
pw	pw
px	px
py	py
q	q
q1	q-1
q2	q-2
q3	q-3
qb	qb
qc	qc
qe	qe
qf	qf
qi	qi
qn	qn
qp	qp
qq	qq
qs	qs
qt	qt
qualfiedName	qualfied-name
queryCacheRegion	query-cache-region
queryClass	query-class
queryDescription	query-description
querySection	query-section
question	question
quirkCssBorderCollapseFor0Padding	quirk-css-border-collapse-for-0-padding
quirkCssBorderCollapseInside	quirk-css-border-collapse-inside
quoteFiles	quote-files
r	r
r1	r-1
r2	r-2
rV	r-v
ra	ra
raRuleString	ra-rule-string
radius0	radius-0
radius1	radius-1
radiusH	radius-h
radiusW	radius-w
railsVersion	rails-version
randomFile	random-file
rangeSpec	range-spec
rangesToIgnore	ranges-to-ignore
rankToRecalc	rank-to-recalc
ratio_desc	ratio-desc
rb	rb
rc	rc
rd	rd
re	re
reachability	reachability
react	react
readAccess	read-access
readOnlyTC	read-only-tc
readState	read-state
readStatus	read-status
readTimeOut	read-time-out
readableFiles	readable-files
readerFieldToValIds	reader-field-to-valids
reads	reads
ready	ready
realClassName	real-class-name
realKeyResolver	real-key-resolver
realRequest	real-request
realTarget	real-target
realm	realm
realtheight	real-t-height
rebindPermOracle	rebind-perm-oracle
recalculate	recalculate
receiverClass	receiver-class
receiverEnd	receiver-end
recordId	record-id
recordToLock	record-to-lock
recordType	record-type
recordedAnnotations	recorded-annotations
rectHeight	rect-height
recurse	recurse
recusive	recusive
reenteredContext	reentered-context
refArray	ref-array
refClassIdx	ref-class-idx
refInvalidChar	ref-invalid-char
refNames	ref-names
refStyleName	ref-style-name
refacElemsColl	refac-elems-coll
referencType	referenc-type
referenceToReinitialize	reference-to-reinitialize
referenced	referenced
referencedEntity	referenced-entity
referencedVocabualries	referenced-vocabualries
references	references
refererField	referer-field
referredByContainer	referred-by-container
referrerLocation	referrer-location
reformatting	reformatting
reg_type	reg-type
regenSchemaAttrs	regen-schema-attrs
registerButton	register-button
registeredFontFiles	registered-font-files
registrationBehavior	registration-behavior
registryObjects	registry-objects
relatedMappings	related-mappings
relatedRoots	related-roots
relation	relation
relative	relative
relativeName	relative-name
relativeSourceBase	relative-source-base
releaseNote	release-note
remainingData	remaining-data
rememberOld	remember-old
remoteActionListener	remote-action-listener
remoteFolder	remote-folder
remotePath	remote-path
remoteRef	remote-ref
remoteSocket	remote-socket
remoteUIHost	remote-ui-host
removeAllLabel	remove-all-label
removeCandidates	remove-candidates
removeDirectoryItself	remove-directory-itself
removedProject	removed-project
removedValue	removed-value
renamingWhat	renaming-what
repeatLastParameter	repeat-last-parameter
replaceExpr	replace-expr
replaceFunctionName	replace-function-name
replacementLength	replacement-length
replyBer	reply-ber
replytoList	reply-to-list
repoFilter	repo-filter
reportColour	report-colour
reportGenerator	report-generator
repositoryAnnotationType	repository-annotation-type
reqAddr	req-addr
reqHeaders	req-headers
req_type	req-type
requestControls	request-controls
requestJavaFXVersion	request-java-fx-version
requestService	request-service
requestedByUser	requested-by-user
requestedID	requested-id
requestedId	requested-id
requestedMediaType	requested-media-type
requireDeploymentDescriptor	require-deployment-descriptor
requireSession	require-session
requiredAnnotationSignature	required-annotation-signature
requiredAttributes	required-attributes
requiredParameterName	required-parameter-name
requirements	requirements
reservedNames	reserved-names
resizingAllowed	resizing-allowed
resolutionLoader	resolution-loader
resolveType	resolve-type
resolveTypes	resolve-types
resourceAdapterModuleName	resource-adapter-module-name
resourceClass	resource-class
resourceMapping	resource-mapping
resourceOracle	resource-oracle
resourcePool	resource-pool
resourcesDir	resources-dir
responseState	response-state
responseStreamWriter	response-stream-writer
responseVal	response-val
restArg	rest-arg
restartList	restart-list
restartPrepareTask	restart-prepare-task
restoreButtonLabel	restore-button-label
restoreLocation	restore-location
restored	restored
restrictedPermissions	restricted-permissions
restrictors	restrictors
resultConverter	result-converter
resultField	result-field
resultPath	result-path
resultReader	result-reader
resultType	result-type
resultVarName	result-var-name
resultantPackages	resultant-packages
resultsByIDs	results-by-ids
resultsHtml	results-html
resumeEx	resume-ex
resumeLock	resume-lock
resumeValid	resume-valid
retobj	ret-obj
returnElem	return-elem
returnPackagename	return-package-name
returndes	return-des
returnedClass	returned-class
returnsInterface	returns-interface
retvalParams	retval-params
reuseFields	reuse-fields
revertOrder	revert-order
rewriting	rewriting
rf	rf
rfc2253Compliant	rfc2253-compliant
rg	rg
rh	rh
ri	ri
rightClip	right-clip
rightFullContext	right-full-context
rightIsNonnull	right-is-nonnull
rightLength	right-length
risul	risul
rj	rj
rl	rl
rm	rm
rmiServiceName	rmi-service-name
rn	rn
ro	ro
roleClassNames	role-class-names
roleHint	role-hint
roleInfoName	role-info-name
rolename	role-name
rootClassInstrumentation	root-class-instrumentation
rootClassName	root-class-name
rootEntityName	root-entity-name
rootField	root-field
rootInjectionType	root-injection-type
rootLocalFolder	root-local-folder
rootModCount	root-mod-count
rootName	root-name
rootProjects	root-projects
rootToResolvedEntries	root-to-resolved-entries
roundToLaterVersion	round-to-later-version
rounding_mode	rounding-mode
rowAllocator	row-allocator
rowChartHeaderWidth	row-chart-header-width
rowCounts	row-counts
rowHtml	row-html
rowSignature	row-signature
row_count	row-count
rowsInput	rows-input
rp	rp
rq	rq
rr	rr
rs	rs
rs2Num	rs-2-num
rscFixedMeta	rsc-fixed-meta
rt	rt
ru	ru
rule1	rule-1
rule2	rule-2
ruler	ruler
rules	rules
runAs	run-as
runFile	run-file
runGC	run-gc
runOn	run-on
runUnderLock	run-under-lock
runnables	runnables
runner	runner
runtAttribute	run-tattribute
runtimeTimeType	runtime-time-type
rv	rv
rw	rw
rx	rx
ry	ry
s	s
s0	s-0
s1	s-1
s2	s-2
s3	s-3
s4	s-4
s5	s-5
sE	s-e
sJavaSourceFile_	s-java-source-file
sLabelKey	s-label-key
sOrganization	s-organization
s_	s
sa	sa
salesDate	sales-date
salient	salient
sampleSize	sample-size
samplingPeriod	sampling-period
savedBytes	saved-bytes
saving	saving
sb	sb
sc	sc
scalar	scalar
scanFromTop	scan-from-top
scannedEntity	scanned-entity
scheduleCaching	schedule-caching
schedulerFactoryClass	scheduler-factory-class
schemaJarFileEntry	schema-jar-file-entry
schemaModel	schema-model
schemaTypeSystem	schema-type-system
scopeChain	scope-chain
scopeContext	scope-context
scopeDepth	scope-depth
scopeRange	scope-range
scopeToRefresh	scope-to-refresh
scopeTraversals	scope-traversals
screenContentKey	screen-content-key
screen_number	screen-number
scref	scref
script	script
scriptBuffer	script-buffer
scriptName	script-name
sd	sd
sdeAttr	sde-attr
se	se
sealGroup	seal-group
searchAll	search-all
searchChar	search-char
searchFrom	search-from
searchHierarchy	search-hierarchy
searchURLFormat	search-url-format
search_function	search-function
search_name	search-name
search_results	search-results
secProfile	sec-profile
secTableAnn	sec-table-ann
secondChanges	second-changes
secondClasspath	second-classpath
secondIs	second-is
secondIt	second-it
secondNode	second-node
secondNodeHandle	second-node-handle
secondPatterns	second-patterns
secondTP	second-tp
secondTimestamp	second-timestamp
seconds_	seconds
secureLink	secure-link
securityMechanism	security-mechanism
seedMode	seed-mode
seeding	seeding
seenInUI	seen-in-ui
selectAllOnFocus	select-all-on-focus
selectConstructName	select-construct-name
selectDatabasePanel	select-database-panel
selectExpr	select-expr
selectNext	select-next
selectedComparator	selected-comparator
selectedCompilerSetName	selected-compiler-set-name
selectedContext	selected-context
selectedMake	selected-make
selectedPaths	selected-paths
selectedResourceMappings	selected-resource-mappings
selectedTopComponent	selected-top-component
selectionIndex	selection-index
selectionMap	selection-map
selectionResize0	selection-resize-0
selectionResize1	selection-resize-1
selfProfile	self-profile
sendMethodName	send-method-name
sendRoles	send-roles
sendSQLERRRM	send-sqlerrrm
senders	senders
sending	sending
sentenceStartOffset	sentence-start-offset
seqName	seq-name
serializationType	serialization-type
servant	servant
servantClassName	servant-class-name
serverAddr	server-addr
serverContext	server-context
serverImpl	server-impl
serverInfo	server-info
serverInstance	server-instance
serverLocation	server-location
serverMode	server-mode
serverPrincipal	server-principal
server_address	server-address
serviceIterator	service-iterator
serviceManager	service-manager
serviceModule	service-module
serviceNode	service-node
serviceSubjectRealm	service-subject-realm
service_mapping	service-mapping
servlets	servlets
sessionIdAlphabet	session-id-alphabet
setBounds	set-bounds
setFactory	set-factory
setFilter	set-filter
setMaxNeddedSize	set-max-nedded-size
setModified	set-modified
setRoots	set-roots
setStorePreferencesRequest	set-store-preferences-request
settingValue	setting-value
settingsCodec	settings-codec
sf	sf
sg	sg
sh	sh
shaded	shaded
shadow	shadow
shapeName	shape-name
shapePaint	shape-paint
shiftKey	shift-key
shortcircuit	shortcircuit
shortenPeriod	shorten-period
shouldLoadWalkers	should-load-walkers
showCreateMIDlet	show-create-midlet
showDefiningType	show-defining-type
showFullPath	show-full-path
showInNextPrevDropdownToolbarActionKey	show-in-next-prev-drop-down-toolbar-action-key
showLastPageButton	show-last-page-button
showManagerOptions	show-manager-options
showObjectMethods	show-object-methods
showOkBtn	show-ok-btn
showOnlyIcon	show-only-icon
showProgressEntry	show-progress-entry
showRecurse	show-recurse
showRoot	show-root
showSuspended	show-suspended
showTypes	show-types
showUserName	show-username
si	si
signal_id	signal-id
signatureValue	signature-value
simpleClassName	simple-class-name
simpleRPCService	simple-rpc-service
sinceTag	since-tag
siteURI	site-uri
siteURL	site-url
sj	sj
sk	sk
skipButton	skip-button
skipIfEmpty	skip-if-empty
skipName	skip-name
skipQuery	skip-query
skipSelectionPage	skip-selection-page
skipSelectionsPage	skip-selections-page
skipTokenCategories	skip-token-categories
sl	sl
slaveDocument	slave-document
slaves	slaves
slownData	slown-data
slowness	slowness
sm	sm
smallFirst	small-first
sn	sn
so	so
soapBinding	soap-binding
socket_performanceLatency	socket-performance-latency
socket_soTrafficClass	socket-so-traffic-class
someColumn	some-column
sortCrit	sort-crit
sortFieldId	sort-field-id
sortObserver	sort-observer
sortRecordClass	sort-record-class
sourceAttachment	source-attachment
sourceBlock	source-block
sourceEncodingPropertyName	source-encoding-property-name
sourceFileMap	source-file-map
sourceHandle	source-handle
sourceInfo	source-info
sourceInfoFile	source-info-file
sourceInfos	source-infos
sourceMethod	source-method
sourceMimeType	source-mime-type
sourceName	source-name
sourceObjectExpression	source-object-expression
sourcePackage	source-package
sourceReader	source-reader
sourceSubItem	source-sub-item
sp	sp
spaceMap	space-map
specialProperty	special-property
specializeElements	specialize-elements
specials	specials
specversion	spec-version
spiWebServicesClientSupport	spi-web-services-client-support
splitBlocks	split-blocks
splitType	split-type
sproHome	spro-home
sq	sq
sr	sr
src2Type	src-2-type
srcFileLine	src-file-line
srcFileObject	src-file-object
srcFont	src-font
srcPluginBase	src-plugin-base
srcRedMask	src-red-mask
srcZipFile	src-zip-file
src_w	src-w
src_x	src-x
src_y	src-y
ss	ss
st	st
stackConfig	stack-config
standardMBean	standard-m-bean
standardMetadataFormatSupported	standard-metadata-format-supported
standby	standby
startCount	start-count
startPage	start-page
startPath	start-path
startPoint	start-point
startTimeNano	start-time-nano
startTimeout	start-timeout
startToken	start-token
start_scope	start-scope
start_state	start-state
stateChangedTasks	state-changed-tasks
stateObject	state-object
stateless	stateless
staticFieldsAndMethodOnly	static-fields-and-method-only
staticInit	static-init
statusInfo	status-info
statusProvider	status-provider
stdlib	stdlib
stdout	stdout
stepSize	step-size
stepping	stepping
stickyTag	sticky-tag
stopOnVMStart	stop-on-vm-start
stopOnline	stop-online
stopPosition	stop-position
stoppedAll	stopped-all
stoppers	stoppers
strategyInterface	strategy-interface
streamResponse	stream-response
streamStorableColIds	stream-storable-col-ids
stream_encryption	stream-encryption
stretchTypeEnum	stretch-type-enum
strictargs	strict-args
string0	string-0
string1	string-1
string2	string-2
string3	string-3
string4	string-4
string5	string-5
string6	string-6
stringTableSection	string-table-section
stringToDecorate	string-to-decorate
stringToSplit	string-to-split
stringVal	string-val
strings	strings
stringsToInsert	strings-to-insert
stripDirectories	strip-directories
structureCreator	structure-creator
styleAttribute	style-attribute
su	su
subBinding	sub-binding
subClassHandle	sub-class-handle
subSequence	sub-sequence
subcat	sub-cat
subclassesMap	subclasses-map
subprojects	subprojects
subroutine	subroutine
substitutionRule	substitution-rule
subtitleColor	subtitle-color
sucGNode	suc-g-node
succesful	succesful
successfulOnly	successful-only
suggestedHasChildren	suggested-has-children
summaryOption	summary-option
sunimg	sun-img
superClsName	super-cls-name
superInterfaceContext	super-interface-context
superReference	super-reference
superclassDescriptor	superclass-descriptor
superclassEnd	superclass-end
supportInstantSubst	support-instant-subst
supportTemplates	support-templates
suppressExceptionNotSignalled	suppress-exception-not-signalled
suppressHeader	suppress-header
suppressPrivatePropertyNotUsed	suppress-private-property-not-used
supressEmptyParameters	supress-empty-parameters
survey_my_id	survey-my-id
suspendStatus	suspend-status
sv	sv
sw	sw
swt_ui	swt-ui
sx	sx
sy	sy
symbolDescriptor	symbol-descriptor
symbolicDeclare	symbolic-declare
symbolicName	symbolic-name
syncMethToAsyncMethMap	sync-meth-to-async-meth-map
sysJreProps	sys-jre-props
systemMenuManager	system-menu-manager
systemModel	system-model
sz	sz
t	t
t0	t-0
t1	t-1
t2	t-2
t3	t-3
t4	t-4
t6	t-6
ta	ta
tableSubdataset	table-sub-dataset
tagBits	tag-bits
tagId	tag-id
tagMap	tag-map
tagName	tag-name
tagName1	tag-name-1
tagName2	tag-name-2
tagNameStack	tag-name-stack
tagNo	tag-no
tagOffset	tag-offset
tagSource	tag-source
taglibs1	tag-libs-1
taglibs2	tag-libs-2
tailCoding	tail-coding
targetConstraints	target-constraints
targetDataSource	target-data-source
targetDecl	target-decl
targetDesc	target-desc
targetImport	target-import
targetMethodParameterTypeNames	target-method-parameter-type-names
targetScript	target-script
targetServlet	target-servlet
targetStorage	target-storage
targetSupertask	target-supertask
targetTheme	target-theme
targetToRepairFor	target-to-repair-for
taskToMove	task-to-move
tb	tb
tc	tc
tcArray	tc-array
tcpIpAddress	tcp-ip-address
tcpListenHost	tcp-listen-host
td	td
te	te
tempLocal	temp-local
templateDataObj	template-data-obj
templateList	template-list
templateParams	template-params
template_column	template-column
templates	templates
templatesDir	templates-dir
termOffsets	term-offsets
termOptions	term-options
terminationCallback	termination-callback
testDouble	test-double
testTaking	test-taking
testValue	test-value
test_id	test-id
testdir	test-dir
testedToken	tested-token
texpr	texpr
text1	text-1
text2	text-2
text3	text-3
textDataSource	text-data-source
textDelimiter	text-delimiter
textDimension	text-dimension
textEnd	text-end
textIDs	text-ids
textLayout	text-layout
textOrientation	text-orientation
textR	text-r
textStatus	text-status
textTruncateIndex	text-truncate-index
textWidget	text-widget
textX	text-x
textY	text-y
text_	text
texts	texts
textsAndIcons	texts-and-icons
tf	tf
tg	tg
th	th
theAction	the-action
theAuthentication	the-authentication
theClass	the-class
theClassName	the-class-name
theConfiguration	the-configuration
theContent	the-content
theContext	the-context
theCurrentLanguage	the-current-language
theCurrentLib	the-current-lib
theDefPlace	the-def-place
theDeleteAction	the-delete-action
theDeployableObject	the-deployable-object
theDropOperation	the-drop-operation
theEdge	the-edge
theExpiryDate	the-expiry-date
theLoader	the-loader
theManager	the-manager
theModelElementObject	the-model-element-object
theNode	the-node
theNotation	the-notation
theOverriddenDescriptor	the-overridden-descriptor
theProject	the-project
theProxyPort	the-proxy-port
theReference	the-reference
theSeconds	the-seconds
theStringifiedNameComponent	the-stringified-name-component
theTableName	the-table-name
theTestURL	the-test-url
theThrowable	the-throwable
theTrace	the-trace
theTransaction	the-transaction
theZipFile	the-zip-file
thisLine	this-line
thisNameSpace	this-name-space
thisSpec	this-spec
threadCPUTimerOn	thread-cpu-timer-on
threadToKill	thread-to-kill
threaded	threaded
threadpoolId	threadpool-id
throwError	throw-error
throwTree	throw-tree
throwsTag	throws-tag
ti	ti
tickMarksOutsideLength	tick-marks-outside-length
tieBreakerMultiplier	tie-breaker-multiplier
tileX	tile-x
tileY	tile-y
tiled	tiled
tiles	tiles
time0	time-0
time1	time-1
timeLeft	time-left
timeToIdle	time-to-idle
timeUnit	time-unit
timeUnitLabel	time-unit-label
timeZoneNameProvider	time-zone-name-provider
time_since_start	time-since-start
timed	timed
timer	timer
timerIdGenerator	timer-id-generator
times	times
timestampTokenInfo	timestamp-token-info
timezone	timezone
timing_id	timing-id
tinfo	t-info
tip_text	tip-text
titleLabel	title-label
tk	tk
tknClosingTag	tkn-closing-tag
tl	tl
tlength	t-length
tm	tm
tmFactory	tm-factory
tmpName	tmp-name
tn	tn
tname	t-name
to	to
toBox	to-box
toCancel	to-cancel
toCls	to-cls
toDCE	to-dce
toDTE	to-dte
toDate	to-date
toDir	to-dir
toEnc	to-enc
toEnd	to-end
toFetch	to-fetch
toGet	to-get
toName	to-name
toRead	to-read
toRepositoryFile	to-repository-file
toUpdateImpl	to-update-impl
to_strs	to-strs
tocIndex	toc-index
token1	token-1
token2	token-2
tokenContextList	token-context-list
tokenFilter	token-filter
tokenPositionsGuaranteedContiguous	token-positions-guaranteed-contiguous
tokenProperties	token-properties
tokenReader	token-reader
tokenSequenceBounds	token-sequence-bounds
tokenString	token-string
tokenTextLen	token-text-len
token_	token
tokens	tokens
tokenstart	token-start
toolTipResource	tool-tip-resource
toolset	toolset
topLogger	top-logger
topScorer	top-scorer
topVisibleAddress	top-visible-address
topWiget	top-wiget
torrent	torrent
torrent_files	torrent-files
touchTime	touch-time
tp	tp
tparTypes	tpar-types
tq	tq
tr	tr
traceMsg	trace-msg
trackMaxScore	track-max-score
trackModels	track-models
transFactory	trans-factory
transaction	transaction
transactionContext	transaction-context
transactionTable	transaction-table
transaction_id	transaction-id
transcodeTarget	transcode-target
transcode_file	transcode-file
transferMode	transfer-mode
transformationFunction	transformation-function
tree_column	tree-column
triggerDefinition	trigger-definition
trimmedValue	trimmed-value
tryInfoTable	try-info-table
tryStatementNode	try-statement-node
ts	ts
tstClassElem	tst-class-elem
tt	tt
tu	tu
tv	tv
tvfPointer	tvf-pointer
tw	tw
twoStageSaveFile	two-stage-save-file
tx	tx
txData	tx-data
txtype	tx-type
ty	ty
typeArgument	type-argument
typeArguments	type-arguments
typeAsString	type-as-string
typeNumber	type-number
typeToUseForComputingDataLength	type-to-use-for-computing-data-length
tz	tz
tzOffset	tz-offset
u	u
u1	u-1
u2	u-2
uRISyntaxException	uri-syntax-exception
uType	u-type
ua	ua
ub	ub
uc	uc
ud	ud
ue	ue
ug	ug
uh	uh
ui	ui
uiClass	ui-class
uk	uk
ul	ul
un	un
unableToDeleteCollection	unable-to-delete-collection
unbound	unbound
underBackColor	under-back-color
underlyingType	underlying-type
uniqueVersion	unique-version
unitsByte	units-byte
unquote	unquote
unresolvedLocation	unresolved-location
up	up
upDownButtons	up-down-buttons
update	update
updateCache	update-cache
updateRemoveAll	update-remove-all
updateSimilarDeclarations	update-similar-declarations
updateStatisticsAll	update-statistics-all
updateStrategy	update-strategy
updatedContainers	updated-containers
uploadContentType	upload-content-type
uploadMax	upload-max
ur	ur
urgent	urgent
urlCodingStrategy	url-coding-strategy
urlEntries	url-entries
us	us
usableObject	usable-object
usageType	usage-type
usageTypes	usage-types
useApostropheForAttributes	use-apostrophe-for-attributes
useAspTagsAsPhp	use-asp-tags-as-php
useBuffer	use-buffer
useCached	use-cached
useCaches	use-caches
useEnvironment	use-environment
useFilters	use-filters
useJavaContext	use-java-context
useLightIcons	use-light-icons
useMastheadImage	use-masthead-image
useNullList	use-null-list
usePreviousValues	use-previous-values
useResourceLocalTx	use-resource-local-tx
useShiftModifier	use-shift-modifier
useSooner	use-sooner
useTextBox	use-text-box
useThisAccess	use-this-access
useTranparency	use-tranparency
useURL	use-url
useUnmapHack	use-unmap-hack
useWorkerThread	use-worker-thread
use_for_all	use-for-all
usedSources	used-sources
userBounds	user-bounds
userCharset	user-charset
userGrouperId	user-grouper-id
userProperties	user-properties
userScale2	user-scale-2
userSpecifiedCapacity	user-specified-capacity
usingBundles	using-bundles
ut	ut
utf8Value	utf8-value
uu	uu
ux	ux
v	v
v0	v-0
v1	v-1
v2	v-2
v3	v-3
v4	v-4
v6	v-6
vH	v-h
vHist	v-hist
v_	v
va	va
val0	val-0
val1	val-1
val2	val-2
validToDate	valid-to-date
validationAware	validation-aware
validationResult	validation-result
validationServices	validation-services
vals	vals
valueAnnotationType	value-annotation-type
valueBinding	value-binding
valueDefault	value-default
valueIsAdjusting	value-is-adjusting
valueLength	value-length
valueVarName	value-var-name
value_key	value-key
valueloc	value-loc
valuesArray	values-array
valves	valves
var0	var-0
var1	var-1
var2	var-2
varData	var-data
varStackPos	var-stack-pos
var_name	var-name
variablesView	variables-view
variantValue	variant-value
vars	vars
vb	vb
vbar	vbar
vc	vc
vcsName	vcs-name
vd	vd
ve	ve
verCfg	ver-cfg
verifyCL	verify-cl
versionLevel	version-level
vf	vf
vg	vg
vh	vh
vhost	v-host
vi	vi
viewFactories	view-factories
viewIds	view-ids
viewLocation	view-location
viewOnly	view-only
viewTitleInfo	view-title-info
viewerComparator	viewer-comparator
visibilityCode	visibility-code
visibleColumns	visible-columns
visibleMarkers	visible-markers
visiblePackages	visible-packages
visibleRow	visible-row
visitedMethodDeclarations	visited-method-declarations
visitedPlaceholders	visited-placeholders
visualStartColumn	visual-start-column
visual_ptr	visual-ptr
vk	vk
vl	vl
vm	vm
vmargs	vm-args
vn	vn
vp	vp
vr	vr
vs	vs
vt	vt
vv	vv
w	w
w0	w-0
w1	w-1
w2	w-2
w3	w-3
wBuf	w-buf
wa	wa
waitIcon	wait-icon
wakeupReason	wakeup-reason
wants	wants
warehouse	warehouse
wasSet	was-set
wasThrown	was-thrown
watchPaths	watch-paths
wb	wb
wc	wc
wd	wd
we	we
webApps	web-apps
webContext	web-context
webLocation	web-location
weekStartsOn	week-starts-on
weightFlags	weight-flags
weights	weights
weightx	weight-x
weighty	weight-y
wf	wf
whereColumns	where-columns
whiteColor	white-color
wi	wi
wideFactor	wide-factor
widthRestriction	width-restriction
wildName	wild-name
win_x_return	win-x-return
win_y_return	win-y-return
window_bits	window-bits
window_value	window-value
withCheckBox	with-check-box
withLevel	with-level
withTime	with-time
within_margin	within-margin
wizardDescriptors	wizard-descriptors
wl	wl
wm	wm
wontHappend	wont-happend
wordBuffer	word-buffer
workRemaining	work-remaining
wp	wp
wr	wr
wrapLine	wrap-line
wrappedException	wrapped-exception
wrapperLifecycles	wrapper-lifecycles
wrappingStyle	wrapping-style
writeLabel	write-label
writtenLen	written-len
wrongAssoc	wrong-assoc
ws	ws
wsMemento	ws-memento
wscompileFeatures	ws-compile-features
wsdlModel	wsdl-model
wsdlurl	wsdl-url
wt	wt
wv	wv
wx	wx
wy	wy
x	x
x0	x-0
x1	x-1
x11CfgData	x11-cfg-data
x2	x-2
x3	x-3
x4	x-4
xRoot	x-root
xValueExpression	x-value-expression
x_	x
x_domainAxis	x-domain-axis
x_plot	x-plot
xa	xa
xaConnection	xa-connection
xact_mgr	xact-mgr
xc	xc
xe	xe
xf	xf
xi	xi
xl	xl
xlintFile	xlint-file
xm	xm
xmlActionsResult	xml-actions-result
xmlElement	xml-element
xmlLangDescFile	xml-lang-desc-file
xmlReferenceBuilderMap	xml-reference-builder-map
xmlX509CRL	xml-x509-crl
xmlreporter	xml-reporter
xn	xn
xo	xo
xp	xp
xpathExpr	xpath-expr
xpathFactoryConfigurationException	xpath-factory-configuration-exception
xr	xr
xs	xs
xt	xt
xw	xw
xx	xx
xy	xy
y	y
y0	y-0
y1	y-1
y2	y-2
y3	y-3
y4	y-4
yData	y-data
yDecline	y-decline
yValueExpression	y-value-expression
ya	ya
yc	yc
ycoeff0	ycoeff-0
ycoeff1	ycoeff-1
ycoeff2	ycoeff-2
yf	yf
ym	ym
yn	yn
yo	yo
ys	ys
yx	yx
yy	yy
z	z
zF	z-f
ze	ze
zeroOut	zero-out
zf	zf
zi	zi
zipEntryName	zip-entry-name
zipPath	zip-path
