$i	i
$t	t
$v	v
A	a
A1	a-1
A2	a-2
ACode	a-code
ALLOW_DELETE	allow-delete
ANT_VERSION_CLASS	ant-version-class
Al	al
B	b
B2	b2
B5	b5
BufferG2D	buffer-g2d
C	c
C2	c2
C4	c4
CANNOT_GET_LOGIC_MAKE_INVISIBLE_MESSAGE	cannot-get-logic-make-invisible-message
CHILD_SPACING	child-spacing
CR	cr
Container	container
D	d
D2	d-2
D4	d-4
D5	d-5
DD	dd
DN	dn
DO	do
DOM_LEVEL2WD_CLASS	dom-level2-wd-class
E	e
E4	e4
EA	ea
EB	eb
EC	ec
EM	em
EV	ev
F	f
Fd	fd
G	g
G0	g-0
G4	g-4
GT	gt
H	h
HACK_VER	hack-ver
I	i
ID	id
IHDR_length	ihdr-length
IP	ip
IV	iv
Id	id
Id_export	id-export
J	j
K	k
K1	k-1
K2	k-2
K3	k-3
K4	k-4
KB	kb
KD	kd
KX	kx
L	l
LF	lf
LS	ls
LT	lt
LValuesCoded	l-values-coded
M	m
M0	m-0
M1	m-1
M2	m-2
M3	m-3
M5	m-5
MAX_READ_CHUNK	max-read-chunk
MM	mm
N	n
NA	na
NL	nl
NN	nn
NO	no
NOARGS	no-args
NO_ARGS	no-args
O	o
OK	ok
OR	or
OS	os
P	p
P11Cipher	p11-cipher
PC	pc
PO	po
PS	ps
Pi	pi
Q	q
Q3	q-3
Qh	qh
Ql	ql
R	r
R2	r-2
RC	rc
RES_CONNECT_FAILED	res-connect-failed
S	s
S2	s-2
S5	s-5
SB	sb
SP	sp
Se	se
Si	si
T	t
T1	t-1
T2	t-2
TC	tc
TO	to
TestORBInitializers	test-orb-initializers
Ti	ti
Tx	tx
U	u
U1	u-1
U2	u-2
UC	uc
UP	up
URIAttr	uri-attr
URLCallback	url-callback
Uh	uh
Ui	ui
V	v
Vh	vh
Vl	vl
W	w
W1	w-1
W2	w-2
WS	ws
X	x
X0	x-0
X1	x-1
X2	x-2
X3	x-3
XA	xa
XB	xb
Y	y
Y0	y-0
Y1	y-1
Y2	y-2
Y3	y-3
_1	1
_2	2
_3	3
_D	d
_X	x
_Y	y
_b	b
_c	c
_d	d
_detailEntityInitial_s	detail-entity-initial-s
_e	e
_f	f
_h	h
_i	i
_j	j
_k	k
_l	l
_locale	locale
_m	m
_n	n
_r	r
_shouldRun	should-run
_t	t
_user	user
_v	v
_w	w
_x	x
_y	y
a	a
a0	a-0
a1	a-1
a2	a-2
a3	a-3
a4	a-4
aColor	a-color
aDescr	a-descr
aE	ae
aFileStr	a-file-str
aHigh	a-high
aI	a-i
aSchemaSource	a-schema-source
aY	a-y
aZ	a-z
aa	aa
ab	ab
absInterval	abs-interval
absoluteEntitiesFileName	absolute-entities-file-name
abstractMethHandles	abstract-meth-handles
ac	ac
acceptedFileNames	accepted-file-names
accesorModifiers	accesor-modifiers
accessOrderField	access-order-field
accumParms	accum-parms
ackMsg	ack-msg
acknowledge	acknowledge
actionMessages	action-messages
actionStyle	action-style
actionsList	actions-list
activationSpecClassToUse	activation-spec-class-to-use
activeConf	active-conf
activeIndex	active-index
activeWorkbenchWindow	active-workbench-window
actualDelayMillis	actual-delay-millis
actualGroup	actual-group
actualTypeArgs	actual-type-args
ad	ad
adaname	ada-name
addAdvised	add-advised
addExprStep	add-expr-step
addNewElement	add-new-element
addSilent	add-silent
addedOrChangedInfos	added-or-changed-infos
addedToBuffer	added-to-buffer
additionalArgs	additional-args
additionalPath	additional-path
addr_adv	addr-adv
addressSize	address-size
adjStackLeft	adj-stack-left
adjustedLineNumber	adjusted-line-number
adptCurrDownLimit	adpt-curr-down-limit
advancedAction	advanced-action
adviceReturnType	advice-return-type
advisorDef	advisor-def
ae	ae
af	af
afterColumnsSize	after-columns-size
afterDash	after-dash
afterLockObjectLookup	after-lock-object-lookup
ag	ag
ah	ah
ai	ai
aj	aj
ajaxFormSubmitBehavior	ajax-form-submit-behavior
ajaxStart	ajax-start
ak	ak
al	al
aliasCount	alias-count
aliasing	aliasing
alignHCenters	align-h-centers
aliveWorkers	alive-workers
allContainerPaths	all-container-paths
allGeneratedFiles	all-generated-files
allInstance	all-instance
allLibraries	all-libraries
allPermElem	all-perm-elem
allPlatforms	all-platforms
allPrimitive	all-primitive
allSaved	all-saved
allSets	all-sets
allSize	all-size
allTableColumns	all-table-columns
allUpToDate	all-up-to-date
allValuesInCategory	all-values-in-category
allowFinish	allow-finish
aload1	a-load-1
aload2	a-load-2
alreadyChecked	already-checked
alreadyShown	already-shown
alreadyUpdated	already-updated
already_has_accel	already-has-accel
altAddress	alt-address
altRect	alt-rect
alwaysOnTop	always-on-top
am	am
amountRead	amount-read
an	an
anchorCert	anchor-cert
andElementsNodeList	and-elements-node-list
annoTree	anno-tree
annotatedTypeEquals	annotated-type-equals
annotationDecls	annotation-decls
anotherTemplate	another-template
antecedent	antecedent
ao	ao
aoResource	ao-resource
ap	ap
appBundleFile	app-bundle-file
appFile	app-file
app_data_key	app-data-key
appdataPath	app-data-path
appendButton	append-button
appliedCompiler	applied-compiler
appliedTable	applied-table
approve	approve
approxL	approx-l
aq	aq
ar	ar
archiveFileObject	archive-file-object
argTrees	arg-trees
argsClasses	args-classes
argsHolderToUse	args-holder-to-use
argsToPass	args-to-pass
argumentNumber	argument-number
arlpright	arlp-right
arrayBindings	array-bindings
arrayForOperation	array-for-operation
arrayStream	array-stream
arrayValues	array-values
artifactPath	artifact-path
artifactProcess	artifact-process
artifactVersion	artifact-version
as	as
as211	as-211
asArray	as-array
asText	as-text
assemblageInformation	assemblage-information
assignedTo	assigned-to
assignmentWorkPerDay	assignment-work-per-day
astElement	ast-element
async_listeners	async-listeners
at	at
atDeclIdx	at-decl-idx
atTargetAnnotation	at-target-annotation
attachement	attachement
attachements	attachements
attrRawName	attr-raw-name
attrSet	attr-set
attrSetList	attr-set-list
attrStr	attr-str
attrURI	attr-uri
attrWildcard	attr-wildcard
attrWithValue	attr-with-value
attributePrefixUri	attribute-prefix-uri
attributeTable	attribute-table
attributesUO	attributes-uo
au	au
authStatement	auth-statement
authenticationSupported	authentication-supported
authorizedRoles	authorized-roles
autoLoad	auto-load
autoScriptLocationPanel	auto-script-location-panel
autowiredArgument	auto-wired-argument
auxDbObject	aux-db-object
auxlength	aux-length
av	av
aw	aw
awtEvent	awt-event
ax	ax
ay	ay
b	b
b0	b-0
b1	b-1
b2	b-2
b3	b-3
b4	b-4
b4Posn	b-4-posn
b5	b-5
b6	b-6
b7	b-7
b8	b-8
b9	b-9
bC	bc
bE	be
bFileMode	b-file-mode
bImageChanged	b-image-changed
bIsActive	b-is-active
bL	b-l
bModel	b-model
bO	b-o
bProcedure	b-procedure
bR	b-r
bReturnByReference	b-return-by-reference
bStride	b-stride
bString	b-string
bToSend	b-to-send
bX	b-x
bZ	b-z
b_last_mod	b-last-mod
ba	ba
backColor	back-color
backtraceFrame	backtrace-frame
badStructure	bad-structure
bareValue	bare-value
barrLen	barr-len
baseClassName	base-class-name
baseFontSize	base-font-size
baseProject	base-project
baseUrlName	base-url-name
base_cc	base-cc
base_id	base-id
base_row_exists	base-row-exists
base_zt	base-zt
baselineDescriptors	baseline-descriptors
basicChecker	basic-checker
bb	bb
bc	bc
bd	bd
be	be
beanInstanceName	bean-instance-name
beanValidationEventListener	bean-validation-event-listener
beforeInitialScanStarted	before-initial-scan-started
beforeOpeningCurly	before-opening-curly
bestDownloadSetting	best-download-setting
bestUploaders	best-uploaders
bf	bf
bg	bg
bh	bh
bi	bi
biType	bi-type
binIncl	bin-incl
binaryNameChars	binary-name-chars
binding	binding
bindingSelector	binding-selector
bitArray	bit-array
bitsPerPixel	bits-per-pixel
bl	bl
blackLineBorder	black-line-border
blockCallbackCount	block-callback-count
blueHex	blue-hex
bm	bm
bn	bn
bo	bo
bodyIsBlank	body-is-blank
boldText	bold-text
booleanChoices	boolean-choices
bootDate	boot-date
boundedValues	bounded-values
boxObject	box-object
bp	bp
bpGroup	bp-group
bq	bq
br	br
bracePositionForArrayInitializerOption	brace-position-for-array-initializer-option
browserWindow	browser-window
bs	bs
bscss	bs-css
bsdir	bs-dir
bstart	b-start
bt	bt
btnListener	btn-listener
btnMsg	btn-msg
bu	bu
bufIndex	buf-index
bufSizeInBytes	buf-size-in-bytes
buffLen	buff-len
bufferNameDeclaration	buffer-name-declaration
bufferPool	buffer-pool
bufferZone	bufferz-one
bufferedGraphics	buffered-graphics
bugNode	bug-node
bugsFiled	bugs-filed
buildSpecCommand	build-spec-command
bulkFetchSize	bulk-fetch-size
bumpLength	bump-length
bundleAcessor	bundle-acessor
bundleManifestIn	bundle-manifest-in
buttonArea	button-area
buttonPanelConstraints	button-panel-constraints
bv	bv
bw	bw
bx	bx
by	by
byDisplayName	by-display-name
byteOnLine	byte-online
bytesRadix	bytes-radix
bytesUsed	bytes-used
c	c
c0	c-0
c1	c-1
c2	c-2
c3	c-3
c3row	c3-row
c4	c-4
c5	c-5
c6	c-6
c7	c-7
c8	c-8
c9	c-9
cA	ca
cArea	c-area
cArg0	c-arg-0
cArg1	c-arg-1
cArg2	c-arg-2
cArg3	c-arg-3
cArgs	c-args
cB	c-b
cFolder	c-folder
cI	c-i
cL	c-l
cLength	c-length
cP	c-p
cR	c-r
cRowset	c-rowset
cTemp	c-temp
cWidth	c-width
cX	c-x
cY	c-y
ca	ca
cacheCatFullURI	cache-cat-full-uri
cache_index	cache-index
cachedBinding	cached-binding
calendarWork	calendar-work
callbackHandlerName	callback-handler-name
calleeNode	callee-node
canClose	can-close
canImport	can-import
canOverWriteBean	can-over-write-bean
cancelWasEnabled	cancel-was-enabled
capitalizedMethodName	capitalized-method-name
cascadeStyles	cascade-styles
caseLabels	case-labels
casesFile	cases-file
castSig	cast-sig
castedTypeChars	casted-type-chars
catchPosition	catch-position
categoryCount	category-count
cb	cb
cc	cc
ccsidDBCEncoding	ccsid-dbc-encoding
cd	cd
ce	ce
cendatalen	cen-data-len
certDerSeq	cert-der-seq
certSubject	cert-subject
cf	cf
cg	cg
ch	ch
changeFile	change-file
changeFlag	change-flag
changePasswordPanel	change-password-panel
changedData	changed-data
changedLine	changed-line
changedList	changed-list
changesTraversals	changes-traversals
charVersion	char-version
charsetStream	char-set-stream
chartHeight	chart-height
checkJspWelcomeFiles	check-jsp-welcome-files
checkboxViewer	checkbox-viewer
checkedChildren	checked-children
checkedModels	checked-models
checksumCalculator	checksum-calculator
childClassFile	child-class-file
childEndOffset	child-end-offset
childPanel	child-panel
childPosition	child-position
childrenWidth	children-width
choicesScroll	choices-scroll
choosableCandidates	choosable-candidates
ci	ci
ciespace	cie-space
cipherInput	cipher-input
circularCPOption	circular-cp-option
cj	cj
ck	ck
ckey1	ckey-1
ckey2	ckey-2
cl	cl
clConsoleInput	cl-console-input
clExp	cl-exp
clExt	cl-ext
classDeclarations	class-declarations
classMethodName	class-method-name
classesMethod	classes-method
classesToWrite	classes-to-write
classpathChange	classpath-change
classpathEl	classpath-el
clauseAsInt	clause-as-int
clazzTmp	clazz-tmp
cleanCommand	clean-command
cleanReadAhead	clean-read-ahead
cleanname	clean-name
cleansed	cleansed
cleanups	cleanups
clearMethod	clear-method
clearedBytes	cleared-bytes
click_listener	click-listener
clickedPath	clicked-path
clientBaseName	client-base-name
clientTrustStorePath	client-trust-store-path
clipHeight	clip-height
clonedChildIndex	cloned-child-index
clonedParams	cloned-params
clonedWebSvc	cloned-web-svc
closableString	closable-string
closeStrings	close-strings
closingParen	closing-paren
closureParam	closure-param
closureWithDelegate	closure-with-delegate
cls0	cls-0
cls1	cls-1
cls2	cls-2
clss	clss
clup	clup
clusterProps	cluster-props
clzs	clzs
clzz	clzz
cm	cm
cmToConnectionsMap	cm-to-connections-map
cmethods	c-methods
cn	cn
co	co
codeNameBase	code-name-base
codeSnippet	code-snippet
codebasePolicy	codebase-policy
codepadFont	codepad-font
colInCtr	col-in-ctr
colPermsUUIDString	col-perms-uuid-string
colTypeId	col-type-id
collected	collected
collectionFilterKeyType	collection-filter-key-type
collectionFromElement	collection-from-element
collector	collector
colnames	col-names
colorSchemeGroup	color-scheme-group
colorSize	color-size
colorTable	color-table
columnAlias	column-alias
columnElement	column-element
columnItemModified	column-item-modified
columnNamesList	column-names-list
columnSortOrder	column-sort-order
columnsCopy	columns-copy
columnsPerConstraint	columns-per-constraint
combine	combine
combinedEntry	combined-entry
comboEvents	combo-events
commandProvider	command-provider
commentExtension	comment-extension
commonAttrLst	common-attr-lst
compLeading	comp-leading
compUnit	comp-unit
compatBundle	compat-bundle
compileMode	compile-mode
compilerAnnotation	compiler-annotation
compilerWorkDir	compiler-work-dir
complianceWarnSettings	compliance-warn-settings
componentBeanName	component-bean-name
componentList	component-list
componentNodes	component-nodes
componentTypeElement	component-type-element
compositionPerspective	composition-perspective
compoundResults	compound-results
concatMethod	concat-method
concreteTypeAnnotation	concrete-type-annotation
conditionArea	condition-area
configFactorySR	config-factory-sr
configFilesPath	config-files-path
configProvs	config-provs
configuredLabel	configured-label
confirmedProjectsList	confirmed-projects-list
conflictingKeys	conflicting-keys
connPoolNodeList	conn-pool-node-list
connectionPanel	connection-panel
connectorContext	connector-context
connectorPoolFinder	connector-pool-finder
consideredRoots	considered-roots
constName	const-name
constantSize	constant-size
constraintsOK	constraints-ok
consumerPermission	consumer-permission
contSize	cont-size
containerAbstractName	container-abstract-name
containerPage	container-page
containerPath	container-path
containerPattern	container-pattern
containerPrefixLength	container-prefix-length
contentDescription	content-description
contentDisposition	content-disposition
contentExtensions	content-extensions
contentLength2	content-length-2
context1	context-1
contextFactory	context-factory
contextPathProperty	context-path-property
contextWithDefaultVariable	context-with-default-variable
contexts	contexts
controlColSpan	control-col-span
controller	controller
convertedMethodCount	converted-method-count
convertedSize	converted-size
converterTypeElement	converter-type-element
cookies_str	cookies-str
coolControl	cool-control
copiedAttributes	copied-attributes
copyConsole	copy-console
copyLeft	copy-left
copyResult	copy-result
correlatedJoins	correlated-joins
countBefore	count-before
countHist	count-hist
countryName	country-name
cout	cout
cp	cp
cpSupported	cp-supported
cpar	cpar
cparent	cparent
cpbi	cpbi
cpbr	cpbr
cpcb	cpcb
cped	cped
cpei	cpei
cpel	cpel
cpes	cpes
cpet	cpet
cpmd	cpmd
cpos	cpos
cppa	cppa
cpsd	cpsd
cpti	cpti
cptm	cptm
cpts	cpts
cpx0	cpx-0
cpx1	cpx-1
cpy0	cpy-0
cpy1	cpy-1
cpy2	cpy-2
cq	cq
cr	cr
cras	cras
crc2	crc-2
crcL	crcl
crdm	crdm
crea	crea
createIndexString	create-index-string
createThread	create-thread
createUnifiedAstEvent	create-unified-ast-event
cred	cred
cref	cref
cres	cres
cresources	c-resources
crit	crit
criterionValue	criterion-value
crlf	crlf
crls	crls
cron	cron
crop	crop
crx0	crx-0
crx1	crx-1
cry0	cry-0
cry1	cry-1
cs	cs
csID	cs-id
csVariant	cs-variant
csca	csca
csd1	csd-1
csd2	csd-2
csd3	csd-3
csd4	csd-4
csdl	csdl
csel	csel
csep	csep
cses	cses
cset	cset
csf2	csf-2
csig	csig
csm1	csm-1
csm2	csm-2
csml	csml
csop	csop
csps	csps
css2	css-2
cssc	cssc
csso	csso
cssv	cssv
cstr	cstr
csub	csub
csym	csym
ct	ct
ctId	ct-id
ctlLogin	ctl-login
ctorCallLocation	ctor-call-location
ctorCallShadow	ctor-call-shadow
ctxCL	ctx-cl
ctxFn	ctx-fn
ctxIU	ctx-iu
ctxTx	ctx-tx
cu	cu
cuLocation	cu-location
curFileExt	cur-file-ext
curWeakW	cur-weak-w
currChoices	curr-choices
currDelta	curr-delta
currDownloadLimit	curr-download-limit
currNameLen	curr-name-len
currSplit	curr-split
currVariable	curr-variable
curr_position	curr-position
currentCount	current-count
currentFocusedWindow	current-focused-window
currentIndentation	current-indentation
currentIndexRow	current-index-row
currentModifiers	current-modifiers
currentQName	current-q-name
currentResetCount	current-reset-count
currentSprint	current-sprint
cursorName	cursor-name
curtokKind	curtok-kind
customWrite	custom-write
cv	cv
cvs_dl_links	cvs-dl-links
cw	cw
cx	cx
cy	cy
d	d
d0	d-0
d1	d-1
d2	d-2
d3	d-3
d4	d-4
d5	d-5
d6	d-6
d7	d-7
d8	d-8
d9	d-9
dB	d-b
dD	d-d
dO	d-o
dP	d-p
dQ	d-q
dRed	d-red
dRel	d-rel
dSer	d-ser
dT	d-t
dURL	d-url
dW	d-w
dX	d-x
dY	d-y
da	da
damagedWidth	damaged-width
dashEdgeFig	dash-edge-fig
dashedGroupId	dashed-group-id
dataAttr	data-attr
dataSourceToUse	data-source-to-use
dataSourcesPlugin	data-sources-plugin
data_id	data-id
data_os	data-os
dataoutputstream	data-output-stream
dayNames	day-names
day_of_month	day-of-month
db	db
dbEncryptionStatus	db-encryption-status
dbProps	db-props
dc	dc
dcChildren	dc-children
dd	dd
ddesc	ddesc
ddiff	ddiff
ddirs	ddirs
de	de
debugStatus	debug-status
debuggerClass	debugger-class
decided	decided
decider	decider
decisionNFAStartState	decision-nfa-start-state
declError	decl-error
declParams	decl-params
declaratioNode	declaratio-node
declarations	declarations
declaredLocally	declared-locally
declaringIndex	declaring-index
declaringTypeName	declaring-type-name
defLocale	def-locale
defSize	def-size
defaultEncodingVal	default-encoding-val
defaultEventType	default-event-type
defaultHarness	default-harness
defaultImportClasses	default-import-classes
defaultLegendHAlignment	default-legend-h-alignment
defaultOpts	default-opts
defaultRootsIter	default-roots-iter
defaultScreenNumber	default-screen-number
defaultServletMappings	default-servlet-mappings
defaultSetTitle	default-set-title
defaultSorter	default-sorter
defaultStatement	default-statement
defaultsButton	defaults-button
deferredMethodSpecified	deferred-method-specified
deferredSyntaxAllowedAsLiteral	deferred-syntax-allowed-as-literal
definitionsFileURL	definitions-fil-eurl
delayTime	delay-time
delegationConstructor	delegation-constructor
deletePosition	delete-position
deleteProjProp	delete-proj-prop
deleteRecord	delete-record
delete_it	delete-it
deletedButtonBox	deleted-button-box
deletedElements	deleted-elements
deletedFilesArray	deleted-files-array
deltaAdv	delta-adv
deltaAge	delta-age
dependancy	dependancy
dependants	dependants
dependentProjects	dependent-projects
deployable	deployable
deprecatedSev	deprecated-sev
deprecatedStr	deprecated-str
dereferenced	dereferenced
derivedFont	derived-font
derivedFrom	derivedfrom
descComp	desc-comp
descFlags	desc-flags
descLabel	desc-label
descriptionWidget	description-widget
descriptorIds	descriptor-ids
descriptorMap	descriptor-map
deselectButton	deselect-button
deserHasCallbackRegistered	deser-has-callback-registered
destCD	dest-cd
destCI	dest-ci
destCU	dest-cu
destFN	dest-fn
destFO	dest-fo
destIL	dest-il
destId	dest-id
destIx	dest-ix
destMD	dest-md
destMP	dest-mp
destModel	dest-model
destRoot	dest-root
destSM	dest-sm
destSV	dest-sv
dest_x	dest-x
dest_y	dest-y
destinationAsContainer	destination-as-container
destinationMetaData	destination-meta-data
destinationTypeComboBox	destination-type-combo-box
destroyMethodName	destroy-method-name
detIndex	det-index
detailLabel	detail-label
details_copy	details-copy
detectDeadlockButton	detect-deadlock-button
detokenated	detokenated
device_name	device-name
df	df
dg	dg
dh	dh
di	di
diInputMap	di-input-map
diagnosticErrorPosition	diagnostic-error-position
dialogChoice	dialog-choice
differentMonth	different-month
digitForPC	digit-for-pc
dirParent	dir-parent
directoryList	directory-list
disableFiltering	disable-filtering
discard_perc	discard-perc
discovers	discovers
discovery	discovery
discrepancy	discrepancy
discreteRaster	discrete-raster
disjoint	disjoint
dispatchMember	dispatch-member
dissolve	dissolve
distanceToLeft	distance-to-left
div_done	div-done
dj	dj
dk	dk
dl	dl
dm	dm
dmsal	dmsal
dn	dn
dnames	dnames
doBind	do-bind
doJsp2	do-jsp-2
doLayoutOnEDT	do-layout-on-edt
doOperation	do-operation
doRestore	do-restore
doaction	do-action
docBegin	doc-begin
docClass	doc-class
docLine	doc-line
docList	doc-list
docTitle2	doc-title-2
docToGo	doc-to-go
docTool	doc-tool
docTypeIndex	doc-type-index
documentHoverLine	document-hover-line
documentItemOffset	document-item-offset
documentationAttrs	documentation-attrs
domDOCTYPE	dom-doctype
domainDir	domain-dir
domainDoc	domain-doc
domainDtd	domain-dtd
dominantPluginGroupIds	dominant-plugin-group-ids
dominantRtInfo	dominant-rt-info
dominators	dominators
dontCheckDependencies	dont-check-dependencies
downButton	down-button
downMeshIndex	down-mesh-index
dp	dp
dq	dq
dr	dr
dragDetect	drag-detect
drawSize	draw-size
dropSupport	drop-support
dropdownPopup	dropdown-popup
droppedFile	dropped-file
ds	ds
dstHSL	dst-hsl
dstMax	dst-max
dstNow	dst-now
dstOfs	dst-ofs
dstOut	dst-out
dstPeer	dst-peer
dt	dt
dtusec	dtu-sec
du	du
dummyPath	dummy-path
dumpValue	dump-value
dupDtdNames	dup-dtd-names
dupMailResources	dup-mail-resources
dv	dv
dvFactory	dv-factory
dw	dw
dx	dx
dy	dy
e	e
e0	e-0
e1	e-1
e2	e-2
e2Global	e2-global
e3	e-3
e4	e-4
eContentBER	e-content-ber
eI	e-i
eL	e-l
eWordNum	e-word-num
ea	ea
eager	eager
earBuildDir	ear-build-dir
earlyWakeupCount	early-wakeup-count
eb	eb
ec	ec
echoLevel	echo-level
eclipse21Profile	eclipse21-profile
eclipseIniFile	eclipse-ini-file
ed	ed
edMementos	ed-mementos
edgesBetweenSets	edges-between-sets
editions	editions
ee	ee
eeHome	ee-home
ef	ef
effLimit	eff-limit
eh	eh
ei	ei
ej	ej
ejb2xRemoteInterface	ejb2x-remote-interface
ejbEnvEntries	ejb-env-entries
ejbLocalRefNames	ejb-local-ref-names
ejbVersion	ejb-version
ejbdobj	ejb-d-obj
ek	ek
el	el
elabel	elabel
elemDef	elem-def
elemDig	elem-dig
elemEnd	elem-end
elemFig	elem-fig
elementColor	element-color
elementsToRefresh	element-store-fresh
em	em
emailAttributes	email-attributes
embeddedPkSupport	embedded-pk-support
embeddedTypes	embedded-types
embeddings	embeddings
emptyCategories	empty-categories
emptyEditorDescriptor	empty-editor-descriptor
emptyParents	empty-parents
en	en
enabledFilterIds	enabled-filter-ids
enabledIDs	enabled-ids
enabledIds	enabled-ids
enabler_plugin	enabler-plugin
enclosedType	enclosed-type
encodedVarBindCount	encoded-var-bind-count
encoded_size	encoded-size
encoderUpto	encoder-upto
encodingEnd	encoding-end
encodingIndex	encoding-index
encodingOkay	encoding-okay
encodingStyle	encoding-style
encodingSupport	encoding-support
endBounds	end-bounds
endDiff	end-diff
endDirs	end-dirs
endFieldExclusive	end-field-exclusive
endOfEmptyToken	end-of-empty-token
endYear	end-year
end_diag	end-diag
endorsedDirsString	endorsed-dirs-string
entityListenerClasses	entity-listener-classes
entriesLine	entries-line
entriesList	entries-list
entryEdge	entry-edge
entrySetType	entry-set-type
entryWelcome	entry-welcome
envVarMatcher	env-var-matcher
eo	eo
ep	ep
eprNode	epr-node
eprom	eprom
eq	eq
er	er
errOStream	err-o-stream
error_entries	error-entries
es	es
escSequence	esc-sequence
et	et
eu	eu
ev	ev
evalResult	eval-result
evaluateNow	evaluate-now
evtKeyStroke	evt-key-stroke
evtPoint	evt-point
ew	ew
ex	ex
exCount	ex-count
excBinding	exc-binding
excName	exc-name
exceptionInfo	exception-info
exceptionInit	exception-init
exceptionObjectId	exception-object-id
exceptionRequest	exception-request
exclLocalsProperty	excl-locals-property
excludeResultPrefixesAttr	exclude-result-prefixes-attr
exclusiveImageEndOffset	exclusive-image-end-offset
excontrol	ex-control
exePart	exe-part
exePath	exe-path
execCP	exec-cp
execId	exec-id
exectx	exec-tx
executors	executors
exeext	exe-ext
exisitngIDs	exisitng-ids
existResource	exist-resource
existedTables	existed-tables
existingAttrUse	existing-attr-use
existingCL	existing-cl
existingDM	existing-dm
existingDownload	existing-download
existingES	existing-es
existingFO	existing-fo
existingFk	existing-fk
existingFound	existing-found
existingFs	existing-fs
existingID	existing-id
existingIU	existing-iu
existingId	existing-id
existingMs	existing-ms
existingNS	existing-ns
existingRootElement	existing-root-element
existingSC	existing-sc
existingSeverity	existing-severity
existingSf	existing-sf
existingTM	existing-tm
existingTx	existing-tx
existingType	existing-type
existingWorkingSets	existing-working-sets
existing_participants	existing-participants
existing_results	existing-results
exitRescue	exit-rescue
exnTable	exn-table
expContext	exp-context
expOffset	exp-offset
expOverflow	exp-overflow
expandTestCode	expand-test-code
expandedServiceId	expanded-service-id
expander_style	expander-style
expbool	exp-bool
expectedEndingToken	expected-ending-token
expectedName	expected-name
expectedShortReadableName	expected-short-readable-name
expiration	expiration
exponentSign	exponent-sign
exportDiffSupport	export-diff-support
exportMap	export-map
exposedAs	exposed-as
expressionModel	expression-model
expressionsArray	expressions-array
extPoint	ext-point
extType	ext-type
extTypeName	ext-type-name
extensionPointManager	extension-point-manager
extensionRelativePath	extension-relative-path
extensionType	extension-type
externalObject	external-object
externalOwnersURI	external-owners-uri
extraContext	extra-context
extraDocs	extra-docs
extraHiddenTypes	extra-hidden-types
extraOperand	extra-operand
extraUnitLabel	extra-unit-label
extractParser	extract-parser
ey	ey
f	f
f0	f-0
f1	f-1
f2	f-2
f3	f-3
f4	f-4
f5	f-5
f6	f-6
f7	f-7
f8	f-8
f9	f-9
fA	f-a
fB	f-b
fC	f-c
fDecls	f-decls
fEvidence	f-evidence
fJ	f-j
fMainTypeName	f-main-type-name
fManager	f-manager
fN	f-n
fO	f-o
fProperty	f-property
fR	f-r
f_root	f-root
fa	fa
faceletsEnabled	facelets-enabled
factoryActions	factory-actions
factualClass	factual-class
fakeAttributes	fake-attributes
fakeUid	fake-uid
falseAltEv	false-alt-ev
faultNames	fault-names
faultPanels	fault-panels
favoredCoding	favored-coding
fb	fb
fc	fc
fd	fd
fdType	fd-type
fe	fe
featureFile	feature-file
featureScriptGenerator	feature-script-generator
ff	ff
fg	fg
fh	fh
fi	fi
fieldUpdate	field-update
fieldsName	fields-name
figsWithIcon	figs-with-icon
fileConst	file-const
fileEntry	file-entry
fileExtensionString	file-extension-string
fileInputStream	file-input-stream
fileJava	file-java
fileRead	file-read
filedName	filed-name
filesById	files-by-id
fillMinX	fill-min-x
fillMinY	fill-min-y
filterAdvice	filter-advice
filterFeatures	filter-features
filterLayout	filter-layout
filterMode	filter-mode
filterProperty	filter-property
filter_path	filter-path
filteredArgs	filtered-args
filtersList	filters-list
filtersMem	filters-mem
finalAdded	final-added
finalEvent	final-event
findDynamics	find-dynamics
finderPanel	finder-panel
finishSlackDuration	finish-slack-duration
fireIt	fire-it
fireMethod	fire-method
firmlyAssociated	firmly-associated
firstColonIndex	first-colon-index
firstDigit	first-digit
firstListItem	first-list-item
firstMinSize	first-min-size
firstStep	first-step
firsttime	first-time
fixOnUpdate_s	fix-on-update-s
fixedStr	fixed-str
fixedSum	fixed-sum
fixnumNode	fix-num-node
fj	fj
fk	fk
fkIsNull	fk-is-null
fkSecondPasses	fk-second-passes
fl	fl
flatEnclosingTypeNames	flat-enclosing-type-names
flavorSupported	flavor-supported
floatArray	float-array
floatValueIndex	float-value-index
flushEventListener	flush-event-listener
fm	fm
fn	fn
fo	fo
focusedRow	focused-row
folderHandle	folder-handle
foldsSearch	folds-search
follower	follower
fontColorElem	font-color-elem
fontControl	font-control
fontFiles	font-files
fontSizeGroup	font-size-group
footer	footer
footerFmt	footer-fmt
forBlock	for-block
forDebug	for-debug
forceBetaUpgrade	force-beta-upgrade
forceRead	force-read
forceWrapping	force-wrapping
foreground2	foreground-2
foregrounds	foregrounds
foreignKeyColumns	foreign-key-columns
formBaseClassEx	form-base-class-ex
formattedContent	formatted-content
formatterNewLineOpeningBrace	formatter-new-line-opening-brace
forwardMeta	forward-meta
foundParameter	found-parameter
foundReplyTo	found-reply-to
foundVacuousComparison	found-vacuous-comparison
found_usable	found-usable
fp	fp
fq	fq
fr	fr
fractLen	fract-len
fractNum	fract-num
fragmentResource	fragment-resource
frameID	frame-id
frameId	frame-id
frameLengthMs	frame-length-ms
frameMs	frame-ms
frameNo	frame-no
framePanel	frame-panel
framePattern	frame-pattern
frameWidth	frame-width
frameno	frame-no
freshRange	fresh-range
freshnessStr	freshness-str
friendMuffinsTotalMaxSize	friend-muffins-total-max-size
frmSize	frm-size
from1	from-1
from2	from-2
fromI	from-i
fromL	from-l
fromWidth	from-width
fromX	from-x
fromY	from-y
from_loc	from-loc
from_sig	from-sig
froml	from-l
froms	froms
fromx	from-x
front	front
froot	f-root
fs	fs
ft	ft
fu	fu
fullBuildRequired	full-build-required
fullProvider	full-provider
fullStringValue	full-string-value
funClass	fun-class
functionCallsList	function-calls-list
futureTask	future-task
fv	fv
fw	fw
fwkIsDirectory	fwk-is-directory
fx	fx
fy	fy
g	g
g0	g-0
g1	g-1
g2	g-2
g3	g-3
gCell	g-cell
gD	gd
gMask16	g-mask16
gMask32	g-mask32
gRadio	g-radio
gS	gs
ga	ga
gameDesign	game-design
gapInterval	gap-interval
gapsToResize	gap-store-size
gateST	gate-st
gb	gb
gc	gc
gc_idx	gc-idx
gd	gd
ge	ge
gemTool	gem-tool
genFuncSize	gen-func-size
gen_tcp	gen-tcp
gen_udp	gen-udp
genderVariant	gender-variant
generated	generated
generatedBody	generated-body
generatedClassName	generated-class-name
generatedFunctionalTestClasses	generated-functional-test-classes
generatedOffset	generated-offset
generater	generater
generator	generator
generatorName	generator-name
genericBalance	generic-balance
genericParamTypes	generic-param-types
gerAppClient	ger-app-client
gerPersistenceContextRefsUntyped	ger-persistence-context-refs-untyped
getHost	get-host
getOut	get-out
getPluginMethod	get-plugin-method
getProp	get-prop
getname	get-name
gf	gf
gfDesc	gf-desc
gg	gg
gh	gh
gi	gi
gl	gl
glass	glass
globalClassPath	global-class-path
globalPoint	global-point
gm	gm
gn	gn
gnome_vfs_url_show	gnome-vfs-url-show
go	go
goingToSleep	going-to-sleep
gotRemoteException	got-remote-exception
gp	gp
gq	gq
gr	gr
grantable	grantable
granularities	granularities
graphManager	graph-manager
graphicStyle	graphic-style
greenHeight	green-height
greport	g-report
gridData2	grid-data-2
gridData3	grid-data-3
groupAlignmentNode	group-alignment-node
grownNewPaths	grown-new-paths
gs	gs
gspTokenSequence	gsp-token-sequence
gt	gt
gu	gu
guessing	guessing
guessingRequired	guessing-required
gv	gv
gw	gw
gwtTestType	gwt-test-type
gx	gx
gy	gy
gz	gz
h	h
h0	h-0
h1	h-1
h2	h-2
h3	h-3
hA	h-a
hB	h-b
hC	h-c
hN	h-n
hType	h-type
hV	h-v
h_	h
ha	ha
hackMimeType	hack-mime-type
hadPreviousInput	had-previous-input
halfSize	half-size
halted	halted
haltright	halt-right
halves	halves
handlerFO	handler-fo
handlerFo	handler-fo
handlerPC	handler-pc
handlerpc	handler-pc
hasAlpha	has-alpha
hasExtensions	has-extensions
hasPrivateChanges	has-private-changes
hasPublicChanges	has-public-changes
hasResults	has-results
hasSystemCache	has-system-cache
hasUserFunction	has-user-function
hasValueToSave	has-value-to-save
hasWebservicesMD	has-webservices-md
hash_start	hash-start
hashslot	hash-slot
haveXercesParser	have-xerces-parser
hb	hb
hbTmLookupClassName	hb-tm-lookup-class-name
hc	hc
hd	hd
he	he
headerTable	header-table
header_size	header-size
headers_str	headers-str
headlessProperty	headless-property
heightStep	height-step
heightWithoutStereo	height-without-stereo
hello	hello
helpHS	help-hs
helpID	help-id
helpId	help-id
helpMI	help-mi
helpSetName	help-set-name
helpUI	help-ui
helper	helper
helpersList	helpers-list
helptext	help-text
hereDoc	here-doc
hf	hf
hg	hg
hgConfigFiles	hg-config-files
hgExecutable	hg-executable
hh	hh
hi	hi
hiddenFrames	hidden-frames
hideNonPublic	hiden-on-public
hierarchy	hierarchy
historyItems	history-items
historyLimit	history-limit
historyfile	history-file
hitsMap	hits-map
hitsSet	hits-set
hl	hl
hm	hm
hmargin	h-margin
hn	hn
ho	ho
homeBase	home-base
homeDirFile	home-dir-file
homeMethods	home-methods
hopsTto1	hops-tto-1
hopsTto2	hops-tto-2
horizontalAlignment	horizontal-alignment
hostFragments	host-fragments
hp	hp
hq	hq
hr	hr
hrefURI	href-uri
hrefUrl	href-url
hs	hs
ht	ht
htmlEditorProcess	html-editor-process
hu	hu
hv	hv
hw	hw
hx	hx
hy	hy
hyperlinkColor	hyperlink-color
hyphenCnt	hyphen-cnt
i	i
i0	i-0
i1	i-1
i2	i-2
i3	i-3
i4	i-4
i5	i-5
i6	i-6
i7	i-7
i8	i-8
iAddedPosition	i-added-position
iH	i-h
iListener	i-listener
iNewColCount	i-new-col-count
iR	i-r
iSourceViewer	i-source-viewer
iW	i-w
ia	ia
ib	ib
ic	ic
id	id
idColumn	id-column
idcheckable	id-checkable
idlFrom	idl-from
idrefName	idref-name
ie	ie
ifStatement	if-statement
ifaceComponent	iface-component
ig	ig
ignoreXSIType	ignore-xsi-type
ih	ih
ii	ii
ij	ij
ik	ik
il	il
im	im
imageName	image-name
imageResNames	image-res-names
imageString	image-string
imgString	img-string
impNameNode	imp-name-node
impNode	imp-node
implObject	impl-object
importFromSources	import-from-sources
importRef	import-ref
importRoot	import-root
importURL	import-url
in	in
inButton	in-button
inError	in-error
inMessage	in-message
inNative	in-native
inOthers	in-others
inParentheses	in-parentheses
includeNode	include-node
includedDepN	included-dep-n
includedStyles	included-styles
includesList	includes-list
incomingOrConflicting	incoming-or-conflicting
incrementNesting	increment-nesting
increments	increments
incrementsPos	increments-pos
indentLen	indent-len
indentMap	indent-map
indentValue	indent-value
indentationIncluded	indentation-included
indexBefore	index-before
indexDiff	index-diff
indexLocations	index-locations
indexOfDiff	index-of-diff
indexOfPortSeparator	index-of-port-separator
indexSuffix	index-suffix
indexType	index-type
index_conglomid	index-conglomid
indexedList	indexed-list
indexerData	indexer-data
indexesFiles	indexes-files
indexingContexts	indexing-contexts
infoFile	info-file
infoHeaderSize	info-header-size
inform_complete	inform-complete
inheritedBackground	inherited-background
inheritedBinding	inherited-binding
inheritedByMethods	inherited-by-methods
initLaunchConfigs	init-launch-configs
init_sem	init-sem
initialSolution	initial-solution
initialX	initial-x
initialY	initial-y
initializedFields	initialized-fields
initiate	initiate
injection	injection
innerSite	inner-site
innerSize	inner-size
inputByte	input-byte
inputReader	input-reader
input_length	input-length
insertSpaceAfterAtInAnnotationOption	insert-space-after-at-in-annotation-option
insertSpaceAfterQuestionInWildcardOption	insert-space-after-question-in-wildcard-option
insertSpaceBeforeClosingAngleBracketInParameterizedTypeReferenceOption	insert-space-before-closing-angle-bracket-in-parameterized-type-reference-option
insertionPointElements	insertion-point-elements
installDirectory	install-directory
installList	install-list
installUser	install-user
instanceInitBlock	instance-init-block
instanceTypes	instance-types
instrBuilder	instr-builder
instructionsTextArea	instructions-text-area
intWeights	int-weights
integerValueIndex	integer-value-index
integralValue	integral-value
interceptorBean	interceptor-bean
interfaceElement	interface-element
interfaceNameEnds	interface-name-ends
interfaceRepositorySupported	interface-repository-supported
interfaes	interfaes
interfaze	interfaze
internalActionObj	internal-action-obj
internalAnnotations	internal-annotations
internalHandlerPkgs	internal-handler-pkgs
internedQualifiedNames	interned-qualified-names
internedURL	interned-url
intervalValue	interval-value
invIdRef	inv-id-ref
invhandle	inv-handle
invocationOptions	invocation-options
io	io
ip	ip
ip_range	ip-range
ipixel	ipixel
ipsave	ip-save
ir	ir
is	is
is0x8000000000000000L	is-0x8000000000000000-l
isAbove	is-above
isAjaxResponse	is-ajax-response
isBoolean	is-boolean
isBuggyXalan	is-buggy-xalan
isChangeset	is-change-set
isConstraint	is-constraint
isCrossContext	is-cross-context
isDateFormat	is-date-format
isDestinationInterface	is-destination-interface
isDirty	is-dirty
isEncoded	is-encoded
isExplicitSuper	is-explicit-super
isFirstStatement	is-first-statement
isGroupChild	is-group-child
isHexaDecimal	is-hexa-decimal
isInSecondPass	is-in-second-pass
isInitializingBean	is-initializing-bean
isLineEmpty	is-line-empty
isLocalHost	is-local-host
isLocked	is-locked
isMinimizePrinterJobSizeParam	is-minimize-printer-job-size-param
isMore	is-more
isNested	is-nested
isOneway	is-one-way
isParagraph	is-paragraph
isProgressive	is-progressive
isRelative	is-relative
isRowToUpdate	is-row-to-update
isSameSource	is-same-source
isSlice	is-slice
isSubscript	is-subscript
isSuiteComponentWizard	is-suite-component-wizard
isTextAlgorithmAplied	is-text-algorithm-aplied
isTheSame	is-the-same
isVararg	is-vararg
isVersioned	is-versioned
isascii	is-ascii
isolatedRealm	isolated-realm
issuerDNName	issuer-dn-name
it	it
itemExportXML	item-export-xml
itemHandle	item-handle
itemIndex	item-index
itemPresenter	item-presenter
itemProperty	item-property
iterBrowserRoot	iter-browser-root
iteratorClass	iterator-class
iteratorMethod	iterator-method
iu	iu
iv	iv
iw	iw
ix	ix
iy	iy
j	j
j0	j-0
j1	j-1
j16lib	j16-lib
j2	j-2
j2eeAppProvider	j2ee-app-provider
j2eeSpecVersion	j2ee-spec-version
j3	j-3
j4	j-4
j5	j-5
j6	j-6
jHome	j-home
ja	ja
jarDeploymentPlan	jar-deployment-plan
jarFilesList	jar-files-list
jasperPrint	jasper-print
javaClassCompletor	java-class-completor
javaModule	java-module
javaSrc	java-src
javaStr	java-str
javaUrl	java-url
javaUtils	java-utils
javadocComment	javadoc-comment
javadocResult	javadoc-result
javaversion	java-version
jaxbDetail	jaxb-detail
jaxrpcMappingPath	jaxrpc-mapping-path
jb	jb
jc	jc
jcaRes	jca-res
jcaResourceData	jca-resource-data
jd	jd
jdMainClass	jd-main-class
jdbcJndiName	jdbc-jndi-name
jdiTarget	jdi-target
jdiThread	jdi-thread
je	je
jf	jf
jh	jh
ji	ji
jj	jj
jk	jk
jl	jl
jm	jm
jmods	jmods
jmxServerConnection	jmx-server-connection
jn	jn
jnaDir	jna-dir
jnlpFileContent	jnlp-file-content
jo	jo
joinTableAlias	join-table-alias
jp	jp
jr	jr
jreLink	jre-link
jreList	jre-list
jrmpAdapterLoaded	jrmp-adapter-loaded
js	js
jscroll	jscroll
jsniTypeRef	jsni-type-ref
jsonRequestString	json-request-string
jspApiDoc	jsp-api-doc
jspIndex	jsp-index
jt	jt
ju	ju
juList	ju-list
jumpToken	jump-token
justName	just-name
jv	jv
jw	jw
jx	jx
k	k
k0	k-0
k1	k-1
k2	k-2
k3	k-3
k4	k-4
kI	k-i
ka	ka
kb	kb
kbps_str	kbps-str
kbytes	kbytes
kc	kc
kd	kd
ke	ke
keyBuffer	key-buffer
keyLocked	key-locked
keyMnemonic	key-mnemonic
keySize	key-size
kf	kf
kg	kg
kh	kh
ki	ki
kids2	kids-2
kk	kk
kl	kl
km	km
kn	kn
knownAccessMethods	known-access-methods
knownTypes	known-types
knownVar	known-var
ko	ko
kp	kp
ks	ks
kt	kt
ku	ku
kv	kv
kw	kw
kx	kx
ky	ky
l	l
l0	l-0
l1	l-1
l10ns	l10ns
l2	l-2
l3	l-3
l4	l-4
l5	l-5
l6	l-6
lDataSource	l-data-source
lF	l-f
lFirstObj	l-first-obj
lH	l-h
lIntValue	l-int-value
lNextChar	l-next-char
lP	l-p
lR	l-r
lRowTypeName	l-row-type-name
lStringD32672	l-string-d32672
lV	lv
l_engines	l-engines
l_slope	l-slope
la	la
labelElement	label-element
labelLength	label-length
labelText	label-text
labelsArray	labels-array
languageFile	language-file
largeModelString	large-model-string
largestSetIvarIndex	largest-set-ivar-index
lastAccessCode	last-access-code
lastChangeLine	last-change-line
lastEqualSegment	last-equal-segment
lastGenericStart	last-generic-start
lastInitializerScope	last-initializer-scope
lastMIMEType	last-mime-type
lastMacroParam	last-macro-param
lastMatchEnd	last-match-end
lastMember	last-member
lastOldPos	last-old-pos
lastOrigPos	last-orig-pos
lastParameterEnd	last-parameter-end
lastParenthesisIndex	last-parenthesis-index
lastSingleTag	last-single-tag
lastWeek	last-week
last_biased	last-biased
latestDisplayed	latest-displayed
latestInstalled	latest-installed
latestVersion	latest-version
latestVersions	latest-versions
latest_file_name	latest-file-name
launchConfig	launch-config
launchConfigSelectionArea	launch-config-selection-area
launchPlugins	launch-plugins
layerPaths	layer-paths
layout1	layout-1
layout2	layout-2
layoutControl	layout-control
layoutDir	layout-dir
layoutExp	layout-exp
layoutNeeded	layout-needed
lb	lb
lblCat	lbl-cat
lc	lc
lcToken	lc-token
lcoreInfo	lcore-info
ld	ld
ldapServer	ldap-server
le	le
leafTypeBinding	leaf-type-binding
leftArea	left-area
leftBoolean	left-boolean
leftElement	left-element
leftFrameSrc	left-frame-src
leftFrameTag	left-frame-tag
leftNullable	left-nullable
leftParen	left-paren
leftParentCount	left-parent-count
leftRect	left-rect
left_buckets	left-buckets
left_corner	left-corner
leftmostNonSpace	leftmost-non-space
leftsib	left-sib
legendSettings	legend-settings
lenField	len-field
lenPart0	len-part-0
lenPart1	len-part-1
lenPart2	len-part-2
lenPart3	len-part-3
lengthId	length-id
lengthM1	length-m1
lengthx3	length-x3
lexEnd	lex-end
lexerAttrs	lexer-attrs
lf	lf
lg	lg
lh	lh
li	li
libSelection	lib-selection
libTempFile	lib-temp-file
librariesIterator	libraries-iterator
libraryElement	library-element
licenseProperty	license-property
lightFG	light-fg
likeThreadJob	like-thread-job
lineCache	line-cache
lineColumn	line-column
lineCommentBefore	line-comment-before
lineMentionedMultipleTimes	line-mentioned-multiple-times
lineNumStorage	line-num-storage
lineNumberEnabledPar	line-number-enabled-par
lineNumberXPosition	line-number-x-position
lineOfLastMatch	line-of-last-match
linesPerPage	lines-per-page
linesToKeep	lines-to-keep
linkLogger	link-logger
linksDialog	links-dialog
listHashes	list-hashes
listModuleVersions	list-module-versions
listUIBean	list-ui-bean
list_sr	list-sr
lj	lj
lk	lk
ll	ll
llfisw	llfisw
lm	lm
ln	ln
lo	lo
loadSitePackages	load-site-packages
loadedClassesPainter	loaded-classes-painter
locaFile	loca-file
localCC	local-cc
localCE	local-ce
localCP	local-cp
localCl	local-cl
localCu	local-cu
localDS	local-ds
localEp	local-ep
localFeatureReference	local-feature-reference
localFo	local-fo
localGE	local-ge
localID	local-id
localId	local-id
localImage	local-image
localIs	local-is
localJp	local-jp
localMaxFieldCount	local-max-field-count
localNS	local-ns
localOk	local-ok
localPW	local-pw
localPt	local-pt
localText	local-text
localXY	local-xy
local_x	local-x
local_y	local-y
locales	locales
localiz	localiz
locals0	locals-0
locals1	locals-1
locals2	locals-2
locals3	locals-3
localsN	locals-n
locationExpression	location-expression
locationHints	location-hints
lockNumber	lock-number
lockVar	lock-var
loffset	loffset
logOffMessage	log-off-message
logPane	log-pane
logPath	log-path
logToSearch	log-to-search
loggedClassName	logged-class-name
loggedClassPackage	logged-class-package
loggingReceiver	logging-receiver
logicalScreenWidth	logical-screen-width
loginEventSource	login-event-source
longBytes	long-bytes
longIndex	long-index
lookForExtra	look-for-extra
lookOnlyInOwnerProject	look-only-in-owner-project
lookupAll	lookup-all
lookupInstances	lookup-instances
lookupSize	lookup-size
lowValue	low-value
lowerCaseAlgName	lower-case-alg-name
lowerLimit	lower-limit
lp	lp
lpath	lpath
lq	lq
lr	lr
ls	ls
lt	lt
ltypename	l-type-name
lu	lu
lv	lv
lvmidStr	lvmid-str
lw	lw
lx	lx
ly	ly
m	m
m0	m-0
m1	m-1
m1Bounds	m1-bounds
m2	m-2
m3	m-3
m4	m-4
m5	m-5
mC	m-c
mI	m-i
mP	m-p
mQ	m-q
mR	m-r
m_idleft	m-idleft
ma	ma
macOSFolder	mac-os-folder
macrosEss	macros-ess
mailHeader	mail-header
mainTypeSimpleName	main-type-simple-name
majorAxisSpanInt	major-axis-span-int
majorMRJVersion	major-mrj-version
majorVersionEmbedded	major-version-embedded
malformed	malformed
managedMarkerTypes	managed-marker-types
managerClass	manager-class
mangledNamesSublist	mangled-names-sublist
mapFile	map-file
mapInputSources	map-input-sources
mapIterProxy	map-iter-proxy
mapdata	map-data
mappedServletName	mapped-servlet-name
mappedTypeStr	mapped-type-str
mappingReader	mapping-reader
margin	margin
matchArray	match-array
matchinBracket	matchin-bracket
maxBits	max-bits
maxDimensions	max-dimensions
maxMarginRatio	max-margin-ratio
maxNumString	max-num-string
maxRecords	max-records
maxRevQbParameters	max-rev-qb-parameters
maxWaitCount	max-wait-count
maxWidth1	max-width-1
maxWidths	max-widths
max_changed	max-changed
max_key_size	max-key-size
maximizeEnabled	maximize-enabled
maximumText	maximum-text
maybeLineSpan	maybe-line-span
mb	mb
mbServerConnection	mb-server-connection
mbSize	mb-size
mc	mc
md	md
md5Count	md5-count
me	me
memberCode	member-code
memberContext	member-context
memoryPanel	memory-panel
mentionedColumnName	mentioned-column-name
menuVisibleWhenExpression	menu-visible-when-expression
mergedByCollapsedProperties	merged-by-collapsed-properties
mergedExecutions	merged-executions
mergedLists	merged-lists
message1	message-1
message2	message-2
message3	message-3
messageActive	message-active
messageDecriptor	message-decriptor
messageFormatProposal	message-format-proposal
messageTextAreaPV	message-text-area-pv
messager	messager
messages	messages
metaDataMap	meta-data-map
metaType	meta-type
metatypeName	meta-type-name
methodButton	method-button
methodDefaults	method-defaults
methodHeader	method-header
methodInsert	method-insert
methodIsVarargs	method-is-varargs
methodToExecute	method-to-execute
methodsCount	methods-count
metricID	metric-id
metricId	metric-id
mf	mf
mg	mg
mgfMdName	mgf-md-name
mh	mh
mi	mi
midRegion	mid-region
middleC	middle-c
middleP	middle-p
middleX	middle-x
middleY	middle-y
middlew	middle-w
mightNeedToWeave	might-need-to-weave
mimeContentParts	mime-content-parts
mimePtr	mime-ptr
mimeType1	mime-type-1
mimeType2	mime-type-2
mimeTypes	mime-types
minLen	min-len
minLength	min-length
minODV	min-odv
minPad	min-pad
minPos	min-pos
min_period	min-period
min_value	min-value
minusOneIndex	minus-one-index
minusTwoIndex	minus-two-index
mixedCase	mixed-case
mj	mj
mk	mk
mkDirs	mk-dirs
ml	ml
mlength	m-length
mm	mm
mmods	mmods
mn	mn
mo	mo
modalityMsg	modality-msg
modeCfgList	mode-cfg-list
modelEvent	model-event
modelIsAdjusting	model-is-adjusting
modelsListenersAddedTo	models-listeners-added-to
modifiedAugs	modified-augs
modifiedLocalOptions	modified-local-options
modifiedRoots	modified-roots
modifierKeysColumn	modifier-keys-column
modifyRule	modify-rule
moduleString	module-string
monitor	monitor
monitorObjectId	monitor-object-id
monthPos	month-pos
mouseAdapter	mouse-adapter
mouseMoveCurrent	mouse-move-current
move_from_dir	move-from-dir
movedOutofInterface	moved-out-of-interface
mp	mp
mq	mq
mr	mr
ms	ms
msgDesc	msg-desc
msgDest	msg-dest
msgFormatClass	msg-format-class
msg_removed	msg-removed
msnList	msn-list
mt	mt
mu	mu
mucd	mucd
much	much
muck	muck
mult	mult
multipleOverrides	multiple-overrides
multiplyNumber	multiply-number
mute	mute
mv	mv
mvEl	mv-el
mval	mval
mvis	mvis
mvos	mvos
mvps	mvps
mvtc	mvtc
mw	mw
mx	mx
mxex	mxex
mxic	mxic
my	my
myAe	my-ae
myBB	my-bb
myCm	my-cm
myID	my-id
myIU	my-iu
myIV	my-iv
myId	my-id
myIt	my-it
myIx	my-ix
myKc	my-kc
myLoad	my-load
myLock	my-lock
myM2	my-m2
myNodeInstance	my-node-instance
myOp	my-op
myPk	my-pk
myRecordId	my-record-id
myTV	my-tv
myUpperBound	my-upper-bound
myVM	my-vm
myVN	my-vn
mycl	mycl
myendc	my-end-c
myendl	my-end-l
myid	my-id
myiw	my-iw
n	n
n0	n-0
n1	n-1
n2	n-2
n3	n-3
n4	n-4
n8	n-8
nB	n-b
nC	n-c
nE	n-e
nF	n-f
nFiles	n-files
nFills	n-fills
nI	n-i
nNode	n-node
nParameters	n-parameters
nRes	n-res
nRetries	n-retries
nT	n-t
nUserThreads	n-user-threads
nV	n-v
nWrites	n-writes
nX	n-x
na	na
nameChanged	name-changed
nameOrderable	name-orderable
nameToIdMap	name-to-id-map
nameWithUmlaute	name-with-umlaute
namespaceHandler	namespace-handler
namingCursor	naming-cursor
nativeBuild	native-build
nativejars	native-jars
nb	nb
nbCol	nb-col
nbPlfDir	nb-plf-dir
nbproj	nb-proj
nc	nc
nd	nd
ne	ne
nearestTimestampIndex	nearest-timestamp-index
needCast	need-cast
needClose	need-close
needWCs	need-wcs
neededWidth	needed-width
needsImportRemoval	needs-import-removal
neighborDescent	neighbor-descent
nestedFiles	nested-files
nestedMerged	nested-merged
nestedSqlEx	nested-sql-ex
netConn	net-conn
netInstancePrefs	net-instance-prefs
network_interfaces	network-interfaces
newAExp	new-a-exp
newAnnotationType	new-annotation-type
newBooleanStack	new-boolean-stack
newBundlePaths	new-bundle-paths
newBytesBuffer	new-bytes-buffer
newChains	new-chains
newCharIndex	new-char-index
newClsTree	new-cls-tree
newColumnReference	new-column-reference
newCommentCount	new-comment-count
newCompoundLookup	new-compound-lookup
newDelta	new-delta
newDense	new-dense
newEndPos	new-end-pos
newField	new-field
newFoldLevel	new-fold-level
newFolderInfo	new-folder-info
newFromClause	new-from-clause
newFunctionEnd	new-function-end
newHandlerName	new-handler-name
newHunkName	new-hunk-name
newJbossClient	new-jboss-client
newMasks	new-masks
newMatch	new-match
newMethodC	new-method-c
newMethodDecl	new-method-decl
newMethods	new-methods
newNoInner	new-no-inner
newOrdering	new-ordering
newPerson	new-person
newPrefixExpr	new-prefix-expr
newRefEl	new-ref-el
newReferencedEntries	new-referenced-entries
newRule	new-rule
newSaveable	new-saveable
newSourceFig	new-source-fig
newStrace	new-strace
newTasks	new-tasks
newVMParams	new-vm-params
newValueDialog	new-value-dialog
new_boosted	new-boosted
new_bytes	new-bytes
new_comps	new-comps
new_estimate	new-estimate
new_http_connection	new-http-connection
new_ignore_set	new-ignore-set
new_root_device	new-root-device
new_udp_port	new-udp-port
new_unread	new-unread
new_web_seeds	new-web-seeds
newbranchrow	new-branch-row
newclone	new-clone
newmask	new-mask
nextAngly	next-angly
nextBounds	next-bounds
nextCollected	next-collected
nextDecodedByte	next-decoded-byte
nextHit	next-hit
nextKey	next-key
nextLen	next-len
nextLine	next-line
nextLink	next-link
nextList	next-list
nextLoc	next-loc
nextLso	next-lso
nextMap	next-map
nextMenuItem	next-menu-item
nextMid	next-mid
nextMin	next-min
nextMsg	next-msg
nextNap	next-nap
nextNum	next-num
nextPageId	next-page-id
nextProjectName	next-project-name
nextRandom	next-random
nextRefEl	next-ref-el
nextSecondary	next-secondary
nextSynonymTable	next-synonym-table
nextTokenIdentifier	next-token-identifier
nextUnitStart	next-unit-start
next_bitpos	next-bitpos
nf	nf
ng	ng
nh	nh
ni	ni
nk	nk
nl	nl
nlsel	nlsel
nm	nm
nn	nn
nnotifs	n-not-ifs
no	no
noAttachments	no-attachments
noChars	no-chars
noCloseButton	no-close-button
noJars	no-jars
noOfClassesChecked	no-of-classes-checked
noTotal	no-total
noVargsLength	no-vargs-length
nodeArray	node-array
nodeArtif	node-artif
nodeBefore1	node-before-1
nodeBefore2	node-before-2
nodePropertySet	node-property-set
nonApiBundlesNames	non-api-bundles-names
nonConfusingPattern	non-confusing-pattern
nonNegativeDV	non-negative-dv
nonObservableList	non-observable-list
nonPertinentRevisions	non-pertinent-revisions
nonVariablesList	non-variables-list
nonVisualsNode	non-visuals-node
nonWorkingDays	non-working-days
nonabs	non-abs
nonbaselineHeight	non-baseline-height
normalizedCNB	normalized-cnb
normalizedCol	normalized-col
notLocalMessage	not-local-message
noteText	note-text
nowInDependency	now-in-dependency
np	np
nr	nr
ns	ns
nsPrefix	ns-prefix
nspQName	nsp-q-name
nt	nt
ntn_list	ntn-list
ntype	ntype
nu	nu
nueTry	nue-try
nullableResult	nullable-result
numCharsInGa	num-chars-in-ga
numClasses	num-classes
numExclusionRanges	num-exclusion-ranges
numExclusions	num-exclusions
numNegZeros	num-neg-zeros
numNodesWithDownlinks	num-nodes-with-downlinks
numNonPrivate	num-non-private
numParameters	num-parameters
numProcessors	num-processors
numRolledUpCols	num-rolled-up-cols
numRpcFields	num-rpc-fields
numSlots	num-slots
numTokensConsumed	num-tokens-consumed
numUnboundPrimitives	num-unbound-primitives
numViews	num-views
num_code_atts	num-code-atts
num_from_this_ip	num-from-this-ip
num_ranges	num-ranges
numberOfChanges	number-of-changes
numberOfMissingTypes	number-of-missing-types
number_of_entries	number-of-entries
nv	nv
nw	nw
nx	nx
ny	ny
nz	nz
o	o
o0	o-0
o1	o-1
o2	o-2
o3	o-3
o4	o-4
o5	o-5
oA	o-a
oChild	o-child
oFrame	o-frame
oM	o-m
oN	o-n
oSchemaDir	o-schema-dir
oV	o-v
oa	oa
ob	ob
objImpl	obj-impl
objectBd	object-bd
objectError	object-error
objectID	object-id
objectId	object-id
objectIn	object-in
objectRead	object-read
objectVN	object-vn
objectid	object-id
oc	oc
ocspCause	ocsp-cause
od	od
oe	oe
oelement	o-element
of	of
offsetFromLineAddress	offset-from-line-address
offsetInLine	offset-in-line
offsetLine	offset-line
offsetToOpen	offset-to-open
offsetsInitialized	offsets-initialized
oh	oh
ohelpDescription	o-help-description
oi	oi
oidLen	oid-len
oj	oj
ok	ok
ol	ol
oldAllocated	old-allocated
oldArgTree	old-arg-tree
oldBinaryFiles	old-binary-files
oldCaretPos	old-caret-pos
oldCurrent	old-current
oldDeletable	old-deletable
oldDevice	old-device
oldDividerStyle	old-divider-style
oldDocType	old-doc-type
oldErrorOut	old-error-out
oldFirstID	old-first-id
oldFunctionEnd	old-function-end
oldGreen	old-green
oldHelpCtx	old-help-ctx
oldHtmlDisplayName	old-html-display-name
oldIsInternal	old-is-internal
oldMinDigits	old-min-digits
oldNextCaller	old-next-caller
oldOffs	old-offs
oldOffx	old-offx
oldOffy	old-offy
oldOutput	old-output
oldOwnerElement	old-owner-element
oldPadding	old-padding
oldPostExecutionHook	old-post-execution-hook
oldProvider	old-provider
oldRepos	old-repos
oldRepository	old-repository
oldRowIndex	old-row-index
oldScope	old-scope
oldScore	old-score
oldScrap	old-scrap
oldScrollValue	old-scroll-value
oldSelectionX	old-selection-x
oldSelectionY	old-selection-y
oldSelections	old-selections
oldServInstID	old-serv-inst-id
oldSourceTypeInfo	old-source-type-info
oldTakeback	old-take-back
oldThread	old-thread
oldTrace	old-trace
oldTrans	old-trans
oldTypeCategories	old-type-categories
oldTypeNode	old-typenode
old_out	old-out
old_url	old-url
oldsaveTest	old-save-test
oldsaveText	old-save-text
om	om
omitNorms	omit-norms
on	on
onClickJavaScript	on-click-java-script
onDiskChecksum	on-disk-check-sum
onExceptionPath	on-exception-path
oo	oo
oomeenabled	oome-enabled
oos_str	oos-str
op	op
opString	op-string
openToken	open-token
openedFiles	opened-files
operationTitle	operation-title
operationsLength	operations-length
oppositeBegin	opposite-begin
optimize	optimize
optionArg	option-arg
optionBox	option-box
optionTransferSelect	option-transfer-select
optionsFile	options-file
oq	oq
or	or
orRight	or-right
ordinalMethodSym	ordinal-method-sym
ordinalName	ordinal-name
ordinalSym	ordinal-sym
orerByClaus	orer-by-claus
organization	organization
organizer	organizer
origLayers	orig-layers
origOperations	orig-operations
orig_limit	orig-limit
originalCurrentSchema	original-current-schema
originalEndAst	original-end-ast
originalEndOffset	original-end-offset
originalLoader	original-loader
originalMethods	original-methods
originalRightType	original-right-type
originalSourceLength	original-source-length
os	os
os_values	os-values
osxAdapter	osx-adapter
ot	ot
otherAbsoluteLocation	other-absolute-location
otherAdvice	other-advice
otherBignum	other-big-num
otherBindingsCount	other-bindings-count
otherIndex	other-index
otherInterval	other-interval
otherIsNotEquals	other-is-not-equals
othergnode	other-g-node
ou	ou
our_red_row	our-red-row
outChannel	out-channel
outOfOrderKeyStrokes	out-of-order-key-strokes
outParts	out-parts
outPump	out-pump
outScope	out-scope
outermostClass	outermost-class
outlineStrokeSequenceList	outline-stroke-sequence-list
outphrase	out-phrase
outputBb	output-bb
outputBg	output-bg
outputDirectoryFO	output-directory-fo
outputEl	output-el
outputListener	output-listener
outputStartLine	output-start-line
outputWidth	output-width
outsideBorder	outside-border
ov	ov
overrideValue	override-value
overridesEntity	overrides-entity
overridingProperty	overriding-property
overwriteText	overwrite-text
ovrText	ovr-text
ow	ow
ownLineWidth	own-line-width
ownPdfFontName	own-pdf-font-name
ownTimeAxisLabelColor	own-time-axis-label-color
ownedConfiguration	owned-configuration
ownedWindows	owned-windows
ownees	ownees
owner1	owner-1
owner2	owner-2
ownerPackageName	owner-package-name
owners	owners
ox	ox
oy	oy
p	p
p0	p-0
p1	p-1
p2	p-2
p3	p-3
p4	p-4
p5	p-5
p6	p-6
p7	p-7
pA	p-a
pB	p-b
pGoOn	p-go-on
pH	p-h
pI	p-i
pL	p-l
pPosition	p-position
pS	p-s
pW	p-w
pa	pa
packageConfigs	package-configs
packagePrefix	package-prefix
packedData	packed-data
paeArray	pae-array
pageNumber	page-number
paintDiff	paint-diff
painterContext	painter-context
paneOrientation	pane-orientation
panel1Layout	panel1-layout
parInterval	par-interval
parLevel	par-level
parType	par-type
paraTypes	para-types
parallelCapable	parallel-capable
paramOffset	param-offset
paramReset	param-reset
parameterIterator	parameter-iterator
parameterLength	parameter-length
parameterSignature	parameter-signature
parameterTypeShortNames	parameter-type-short-names
parametersInNew	parameters-in-new
parentContent	parent-content
parentContext	parent-context
parentData	parent-data
parentDelegate	parent-delegate
parentEntiytName	parent-entiyt-name
parentImage	parent-image
parentParentResource	parent-parent-resource
parentResultSets	parent-result-sets
parentStack	parent-stack
parentStart	parent-start
parentVertex	parent-vertex
parent_time	parent-time
parseError	parse-error
parseException	parse-exception
parserClassName	parser-class-name
parserProperty	parser-property
passPhrase	pass-phrase
passedReturnTypeStrippedElement	passed-return-type-stripped-element
pastHeader	past-header
patArr	pat-arr
patDir	pat-dir
patchButton	patch-button
patchRequirements	patch-requirements
patchedFiles	patched-files
pathEndIdx	path-end-idx
pathSegment	path-segment
pattern2Length	pattern-2-length
patternTail	pattern-tail
pb	pb
pc	pc
pd	pd
pdeps	pdeps
pdesc	pdesc
pe	pe
penLineWidth	pen-line-width
periodUnitsStr	period-units-str
persScroll	pers-scroll
persistTrust	persist-trust
pf	pf
pg	pg
ph	ph
phaseListeners	phase-listeners
phoneNumberTextFieldPV	phone-number-text-field-pv
pi	pi
pieceWidth	piece-width
pixelsPerNano	pixels-per-nano
pj	pj
pk	pk
pkgAdmin	pkg-admin
pl	pl
placeMode	place-mode
plafItems	plaf-items
plainFlavor	plain-flavor
plainPassword	plain-password
plannerProject	planner-project
plannerResource	planner-resource
platformArch	platform-arch
platformArgs	platform-args
platformPropName	platform-prop-name
pload	p-load
plot1	plot-1
plot2	plot-2
pluginJARs	plugin-jars
pluginLibraries	plugin-libraries
plusZero	plus-zero
pm	pm
pn	pn
pntOffset	pnt-offset
po	po
pointcutLocation	point-cut-location
pollerThread	poller-thread
polyRgn	poly-rgn
portNameFound	port-name-found
portVarName	port-var-name
posBottomData	pos-bottom-data
posBottomList	pos-bottom-list
positionToNode	position-to-node
possibleCause	possible-cause
possibleDirNames	possible-dir-names
possibleMember	possible-member
possiblePredecessors	possible-predecessors
possibleSupertypeAsArrayType	possible-supertype-as-array-type
post_file	post-file
postserialize	post-serialize
power2m1	power-2-m1
pp	pp
pq	pq
pr	pr
preceedingLineTokens	preceeding-line-tokens
predCtr	pred-ctr
predicatesTemp	predicates-temp
prefCharset	pref-charset
prefWrapperPanel	pref-wrapper-panel
prefixBytes	prefix-bytes
prefixMatchCount	prefix-match-count
prefixOffset	prefix-offset
prefixesMap	prefixes-map
preload	preload
preparedDiffs	prepared-diffs
prependCount	prepend-count
presumedTypeName	presumed-type-name
prevCharIsEscape	prev-char-is-escape
prevEndPosition	prev-end-position
prevFold	prev-fold
prevLogged	prev-logged
prevNextReg	prev-next-reg
prevPhysLine	prev-phys-line
prevRawLengthShift	prev-raw-length-shift
prev_end	prev-end
previewMessage	preview-message
previousCumulativeWork	previous-cumulative-work
previousEntry	previous-entry
previousFieldID	previous-field-id
previousLine	previous-line
previousLineOffset	previous-line-offset
previousLink	previous-link
previousMetaRequirementIU	previous-meta-requirement-iu
previousSelectedItem	previous-selected-item
previousSentenceEnd	previous-sentence-end
previousStates	previous-states
previousTransform	previous-transform
previousTreeEndOffset	previous-tree-end-offset
previouslyActive	previously-active
prim_hand	prim-hand
primaryEntry	primary-entry
printEllipse	print-ellipse
priorPayload	prior-payload
privAdd	priv-add
privateText	private-text
privilege	privilege
problemsCount	problems-count
procFSDCConfig	proc-fsdc-config
processedResources	processed-resources
productsToInstallSize	products-to-install-size
profileAction	profile-action
profileTokens	profile-tokens
progressFrame	progress-frame
projRsc	proj-rsc
projectClassPathEntries	project-class-path-entries
projectHelper	projec-thelper
projectId0	project-id-0
projectIdS	project-id-s
projectIds	project-ids
projectKey	project-key
projectLabel	project-label
projectLoc	project-loc
projectMap	project-map
projectionAnnotation	projection-annotation
projectsArray	projects-array
propGroup	prop-group
propNodes	prop-nodes
propValueType	prop-value-type
property	property
propertyDescriptions	property-descriptions
propertyIndex	property-index
propertyInfo	property-info
propertyNullness	property-nullness
propertySeparator	property-separator
propsElement	props-element
protClass	prot-class
protocolHeaderValue	protocol-header-value
providedExports	provided-exports
providedHandler	provided-handler
provisionCode	provision-code
proxiesFile	proxies-file
proxyDiagClass	proxy-diag-class
proxyInterface	proxy-interface
proxyServlets	proxy-servlets
ps	ps
pseudoTests	pseudo-tests
pt	pt
pu	pu
publicIdentifier	public-identifier
pullCount	pull-count
pv	pv
pw	pw
px	px
py	py
pyHistory	py-history
q	q
q0	q-0
q1	q-1
q2	q-2
q3	q-3
q4	q-4
q5	q-5
q6	q-6
q7	q-7
q8	q-8
q9	q-9
qFactor	q-factor
qNameStack	q-name-stack
qb	qb
qc	qc
qd	qd
qe	qe
qf	qf
qh	qh
qi	qi
qj	qj
qk	qk
qm	qm
qn	qn
qp	qp
qq	qq
qr	qr
qryprctypReceived	qryprctyp-received
qs	qs
qt	qt
qu	qu
qualifiedSourceTypeName	qualified-source-type-name
qualifiedVersion	qualified-version
querySection	query-section
queryTranslators	query-translators
quietness	quietness
quotedFileName	quoted-file-name
quotedIdentifier	quoted-identifier
qy	qy
r	r
r0	r-0
r1	r-1
r2	r-2
r3	r-3
r4	r-4
r5	r-5
r6	r-6
rA	r-a
rB	r-b
rF	r-f
rH	r-h
rI	r-i
rL	r-l
rM	r-m
rMethod	r-method
rN	r-n
rT	r-t
rU	r-u
rV	r-v
rX	r-x
rY	r-y
r_	r
ra	ra
raRuleString	ra-rule-string
radCookie	rad-cookie
radioPanel	radio-panel
radius1	radius-1
radius2	radius-2
radiusx	radius-x
radiusy	radius-y
radixDigits	radix-digits
rangeSequence	range-sequence
rangeTopLine	range-top-line
rangesToIgnore	ranges-to-ignore
rarestMin	rarest-min
rasbeg	ra-sbeg
rasend	ra-send
rb	rb
rc	rc
rcFileName	rc-file-name
rd	rd
re	re
readAccess	read-access
readBeforeReset	read-before-reset
readStatus	read-status
readingNonSpace	reading-non-space
readyToClose	ready-to-close
realSignature	real-signature
realValues	real-values
recConsole	rec-console
recalculate	recalculate
recheck_all	recheck-all
recordType	record-type
rectAreaLower	rect-area-lower
rectIndex	rect-index
recurse	recurse
recursion_trace	recursion-trace
recv_thread	recv-thread
redirectResponse	redirect-response
refAdapter	ref-adapter
refInternal	ref-internal
referenceField	reference-field
referenced	referenced
referencedEntity	referenced-entity
references	references
referredElementName	referred-element-name
reflfunc	ref-l-func
reflist	ref-list
refreshPeriodInt	refresh-period-int
refsEntry	refs-entry
regenSchema	regen-schema
registeredIterator	registered-iterator
relCaptureFile	rel-capture-file
relString	rel-string
rel_path	rel-path
relatedMappings	related-mappings
relatedMethods	related-methods
relation	relation
relative	relative
releaseRows	release-rows
relevantPrjs	relevant-prjs
remoteAuthor	remote-author
remoteMaxVersion	remote-max-version
remotePath	remote-path
remoteProcessErr	remote-process-err
remote_port	remote-port
remotingMessage	remoting-message
removeAttrs	remove-attrs
removeCandidates	remove-candidates
removeInfo	remove-info
removedLoading	removed-loading
renameFileButton	rename-file-button
rename_incomplete	rename-incomplete
replaceAggsVisitor	replace-aggs-visitor
replacementStringIndex	replacement-string-index
replyBer	reply-ber
replyBuf	reply-buf
reply_bytes	reply-bytes
reporterName	reporter-name
reporterr	report-err
reporters	reporters
repositionHandler	reposition-handler
reqHeaders	req-headers
requestAccepts	request-accepts
requestLogHandler	request-log-handler
requestToExpose	request-to-expose
requiredExt	required-ext
resRefType	res-ref-type
resWrapper	res-wrapper
reservedNames	reserved-names
reset_key_button	reset-key-button
resizeAmount	resize-amount
resolveType	resolve-type
resolvedElements	resolved-elements
resolvedParameter	resolved-parameter
resolvedSystemId	resolved-system-id
resolvedTypeBinding	resolved-type-binding
resourceHint	resource-hint
resourcePool	resource-pool
respMesg	resp-mesg
responsePage	response-page
responseState	response-state
responseURL	response-url
responseVal	respons-eval
responseWrapperAn	response-wrapper-an
responseWrapperEl	response-wrapper-el
restartList	restart-list
restored	restored
restrictedPermissions	restricted-permissions
resultClassFiles	result-class-files
resultNotifs	result-notifs
resultPart	result-part
resultPath	result-path
resultTarget	result-target
resumeValid	resume-valid
retentionPolicy	retention-policy
returnedClass	returned-class
revalidatingTask	revalidating-task
reversePrefix	reverse-prefix
rewriteEdit	rewrite-edit
rewriteSession	rewrite-session
rf	rf
rg	rg
rh	rh
rhsMinutes	rhs-minutes
ri	ri
rightArrayElement	right-array-element
rightClip	right-clip
rightLength	right-length
rightLimit	right-limit
rightTitlebarEdge	right-titlebar-edge
risul	risul
riter	r-iter
rj	rj
rk	rk
rl	rl
rm	rm
rmCount	rm-count
rminame	rmi-name
rn	rn
ro	ro
roleACmr	role-a-cmr
rootName	root-name
rowLastNonWhite	row-last-non-white
row_count	row-count
rp	rp
rq	rq
rr	rr
rs	rs
rsaKeyspec	rsa-key-spec
rt	rt
ru	ru
rulename	rule-name
rulesStart	rules-start
runFile	run-file
runStateMappings	run-state-mappings
run_test_cp	run-test-cp
runnable1	runnable-1
runnables	runnables
runner	runner
runtimes	runtimes
rv	rv
rw	rw
rwidth	r-width
rx	rx
ry	ry
s	s
s0	s-0
s1	s-1
s1ArgsLength	s1-args-length
s2	s-2
s3	s-3
s4	s-4
s5	s-5
sB	sb
sBufferSize	s-buffer-size
sCGINames	s-cgi-names
sCurrentParameterValue	s-current-parameter-value
sDelayCore	s-delay-core
sHandback	s-handback
sI	s-i
sL	s-l
sP	s-p
sT	s-t
sTaggedValueConstructor	s-tagged-value-constructor
sU	s-u
sX	s-x
sY	s-y
s_pos	s-pos
sa	sa
salesHome	sales-home
sameDirection	same-direction
sampleFO	sample-fo
sample_end	sample-end
samplingPeriod	sampling-period
sashData	sash-data
saveDestOffset	save-dest-offset
saveFrames	save-frames
savePt	save-pt
saveResumeInterval	save-resume-interval
saveTo	save-to
saveTr	save-tr
saveTx	save-tx
save_pos	save-pos
savecl	save-cl
savedEditors	saved-editors
savedTransaction	saved-transaction
sawOrder	saw-order
sb	sb
sc	sc
scalNode	scal-node
scalar	scalar
scanbit	scanbit
scdPath	scd-path
schemaAttribute	schema-attribute
schemaLocationAttr	schema-location-attr
schemaModel	schema-model
schemaTypeSystem	schema-type-system
sclClass	scl-class
script	script
scriptBaseName	script-base-name
scriptIndex	script-index
scriptName	script-name
scriptStyle	script-style
scrollBounds	scroll-bounds
scrollbarWidth	scrollbar-width
scrollpaneSize	scrollpane-size
sd	sd
se	se
sealingElement	sealing-element
searchEventListenerClass	search-event-listener-class
searchFrom	search-from
searchableElements	searchable-elements
secHeader	sec-header
secMechProxies	sec-mech-proxies
secondChanges	second-changes
secondId	second-id
secondIf	second-if
secondJumps	second-jumps
secondOK	second-ok
secondSize	second-size
secondSt	second-st
secondaryTypeName	secondary-type-name
secondes	secondes
secureLink	secure-link
seeding	seeding
segDoc	seg-doc
segEnd	seg-end
segType	seg-type
selectOrigin	select-origin
selectedContent	selected-content
selectedNonEdges	selected-non-edges
selectedParticipantSecId	selected-participant-sec-id
selectionElements	selection-elements
selectionIndex	selection-index
selectionKeyOps	selection-key-ops
selectionMap	selection-map
selectionMem	selection-mem
selectionPos	selection-pos
selectionRGB	selection-rgb
selectorBuilder	selector-builder
sendMethodName	send-method-name
senders	senders
separatorArguments	separator-arguments
seqIntL	seq-int-l
seqIntT	seq-int-t
serializationFilter	serialization-filter
seriesArray	series-array
servant	servant
serverAddr	server-addr
serverAuthConfigType	server-auth-config-type
serverInfo	server-info
serverLocation	server-location
serverTypeSignature	server-type-signature
serversMap	servers-map
serviceDirName	service-dir-name
serviceGroup	service-group
serviceInterfaceName	service-interface-name
serviceIterator	service-iterator
serviceManager	service-manager
serviceModeAnnotation	service-mode-annotation
serviceModule	service-module
servletContainerInitializers	servlet-container-initializers
servletException	servlet-exception
servletNameUrlPatternsMap	servlet-name-url-patterns-map
servlets	servlets
sessionBeanJNDINameResolver	session-bean-jndi-name-resolver
sessionIfcs	session-ifcs
sessionImpl	session-impl
sessionString	session-string
session_perc_sent	session-perc-sent
setMethodString	set-method-string
setPropertyArgs	set-property-args
setPublicId	set-public-id
setSheet	set-sheet
setsTwo	sets-two
settingSpaceValue	setting-space-value
setupFiles	setup-files
severeErrors	severe-errors
severityCritical	severity-critical
sf	sf
sg	sg
sh	sh
shapeActions	shape-actions
sharedConfigIni	shared-config-ini
sharedOwnerFrame	shared-owner-frame
shellPatternString	shell-pattern-string
shortHandPointerName	short-hand-pointer-name
shortSignatures	short-signatures
shortxorarr	short-xor-arr
shouldExpand	should-expand
shouldInstall	should-install
shouldStop	should-stop
showProgressEntry	show-progress-entry
showPseudoConflicts	show-pseudo-conflicts
showTypes	show-types
shutdownCommand	shutdown-command
si	si
siFile	si-file
siblingCompare	sibling-compare
siblingURI	sibling-uri
siblingURL	sibling-url
sideEffectInitializer	side-effect-initializer
sideGroupLeading	side-group-leading
sigElement	sig-element
signPrefix	sign-prefix
signatureMethod	signature-method
signedJarFile	signed-jar-file
simpleNodesList	simple-nodes-list
simpleRPCService	simple-rpc-service
sinceTag	since-tag
siteSel	site-sel
siteUri	site-uri
siteUrl	site-url
sizeConstraints	size-constraints
sizeOfRestArg	size-of-rest-arg
sj	sj
sk	sk
skipButton	skip-button
sl	sl
slaves	slaves
slideEntry	slide-entry
slotString	slot-string
sm	sm
smdMethodAnnotation	smd-method-annotation
smdMethodParameterAnnotation	smd-method-parameter-annotation
sn	sn
so	so
soapSnapShot	soap-snap-shot
socket_channel	socket-channel
some_elements	some-elements
sortInfo	sort-info
sortMenuItem	sort-menu-item
sounds	sounds
sourceBlock	source-block
sourceFilesAndDirs	source-files-and-dirs
sourceInfo	source-info
sourceInfos	source-infos
sourceIsKeyIndex	source-is-key-index
sourceLevelEl	source-level-el
sourceParent	source-parent
sourceReader	source-reader
sourceSubItem	source-sub-item
sourceTreePath	source-tree-path
sp	sp
spacedKbShortcut	spaced-kb-shortcut
spanningHeaderBorder	spanning-header-border
specRefs	spec-refs
specifiedInterfaces	specified-interfaces
specversion	spec-version
sq	sq
sr	sr
srcAlphaShift	src-alpha-shift
srcCount	src-count
srcFileObject	src-file-object
srcRootFo	src-root-fo
srcRoots2	src-roots-2
src_fo	src-fo
src_x	src-x
src_y	src-y
srcbs	srcbs
srcis	srcis
srlist	sr-list
ss	ss
ssoDomain	sso-domain
st	st
stValue	st-value
stackCount	stack-count
standbyMemento	stand-by-memento
starget	s-target
startOfPrevWord	start-of-prev-word
startPage	start-page
startPath	start-path
startPatt	start-patt
startPoint	start-point
startRange	start-range
startTokenContextPath	start-token-context-path
startingFromSelection	starting-from-selection
startlocline	start-loc-line
startmask	start-mask
startmenuFilePath	start-menu-file-path
startproto	start-proto
staticInit	static-init
statusProvider	status-provider
stdtextcolor	std-text-color
stencilSize	stencil-size
stepSize	step-size
stepleft	step-left
stickyTag	sticky-tag
store_map	store-map
store_ops	store-ops
storedFileMap	stored-file-map
storedSourcePath	stored-source-path
strPattern	str-pattern
strPool	str-pool
strPort	str-port
strPosX	str-pos-x
strPosY	str-pos-y
strictLocking	strict-locking
strikeoutPosition	strikeout-position
string1	string-1
string2	string-2
stringF	string-f
stringright	string-right
strings	strings
structureCreator	structure-creator
styleActionListener	style-action-listener
styleCount	style-count
su	su
subArrayLength	sub-array-length
subImportList	sub-import-list
subProjectRoot	sub-project-root
subTextValue	sub-text-value
sub_id	sub-id
subclassTables	subclass-tables
subclassesMap	subclasses-map
subcmd	sub-cmd
subcom	sub-com
subcon	sub-con
subcontract	sub-contract
subctx	sub-ctx
subqueryQuant	subquery-quant
subquerySupportedStr	subquery-supported-str
subroutine	sub-routine
subshell	sub-shell
substClass	subst-class
substitutedArguments	substituted-arguments
substitutedOtherBounds	substituted-other-bounds
subtopics	subtopics
subvector	subvector
sucGNode	suc-g-node
succesful	succesful
successorTasks	successor-tasks
suffixChars	suffix-chars
suggestedHasChildren	suggested-has-children
suitProject	suit-project
suitableMethods	suitable-methods
superArgs	super-args
superClsName	super-cls-name
superConstructorParameterTypes	super-constructor-parameter-types
superInterfaceBounds	super-interface-bounds
superMethodReturnTypeCv	super-method-return-type-cv
superTags	super-tags
superText	super-text
superclassDoc	superclass-doc
superclassElm	superclass-elm
supportFastDebuggerInstallation	support-fast-debugger-installation
sv	sv
sw	sw
swtButtons	swt-buttons
sx	sx
sy	sy
symbolicName	symbolic-name
symbolicNameTarget	symbolic-name-target
syncInfoSnapTime	sync-info-snap-time
syncMethToAsyncMethMap	sync-meth-to-async-meth-map
syntChooser	synt-chooser
syntheticFields	synthetic-fields
sysJreHome	sys-jre-home
sysPropBootLogDir	sys-prop-boot-log-dir
systemHomeFO	system-home-fo
systemProps	system-props
systemProxy	system-proxy
sz	sz
t	t
t0	t-0
t1	t-1
t2	t-2
t3	t-3
t4	t-4
t5	t-5
t6	t-6
t7	t-7
t8	t-8
t9	t-9
tB	t-b
tF	t-f
tG	t-g
tHighBitsMap	t-high-bits-map
tI	t-i
tPrimitive	t-primitive
tR	t-r
tV	t-v
tValues	t-values
tX	t-x
tY	t-y
ta	ta
tabMessage	tab-message
tabSizes	tab-sizes
tableClosureBounds	table-closure-bounds
tableColumnPrivileges	table-column-privileges
tableSegments	table-segments
tabsKey	tabs-key
taexp	taexp
tagArray	tag-array
tagBits	tag-bits
tagDE	tag-de
tagHandlerClassName	tag-handler-class-name
tagID	tag-id
tagId	tag-id
tagIns	tag-ins
tagIt	tag-it
tagLen	tag-len
tagLib	tag-lib
tagLoc	tag-loc
tagLst	tag-lst
tagMap	tag-map
tagNo	tag-no
tagSource	tag-source
taggedProfileTemplate	tagged-profile-template
tags1	tags-1
tags2	tags-2
tagsInDoc	tags-in-doc
targerNode	targer-node
targetConfigDirectory	target-config-directory
targetIsVirtual	target-is-virtual
targetParentNode	target-parent-node
targetRepositoryFile	target-repository-file
target_user_dir	target-user-dir
taskdesc	task-desc
tasksProps	tasks-props
tb	tb
tc	tc
tcArray	tc-array
tcCreator	tc-creator
tcRefConfigs	tc-ref-configs
tcpAssertion	tcp-assertion
td	td
te	te
teardown	tear-down
tempAttrGrp	temp-attr-grp
tempBundlePropertiesFile	temp-bundle-properties-file
tempLocal	temp-local
tempSeverity	temp-severity
tempStack	temp-stack
tempState	temp-state
tempVector	temp-vector
template1	template-1
template2	template-2
templateIterator	template-iterator
templateO	template-o
templatePort	template-port
templateSrcLev	template-src-lev
templates	templates
templatesDir	templates-dir
termsInDocument	terms-in-document
testFile2	test-file-2
testFiles	test-files
testLoader	test-loader
testdht	test-dht
testdir	test-dir
testdqt	test-dqt
textAreaFm	text-area-fm
textAreaSP	text-area-sp
textHoverKey	text-hover-key
textLayer	text-layer
textLayout	text-layout
textUpto	text-upto
tf	tf
tg	tg
th	th
theAction	the-action
theClass	the-class
theEdit	the-edit
theNode	the-node
theProject	the-project
theSame	the-same
thenStatementIsBlock	then-statement-is-block
theseStats	these-stats
thisByte	this-byte
thisChainBlockers	this-chain-blockers
thisLength	this-length
thisLine	this-line
thisLink	this-link
thisNameSpace	this-name-space
thisProtectionDomain	this-protection-domain
thisPseudoMember	this-pseudo-member
thisSpec	this-spec
this_bits	this-bits
threadLocked	thread-locked
threadNames	thread-names
threadToStop	thread-to-stop
threadsToNotify	threads-to-notify
throwsStr	throws-str
throwsTag	throws-tag
ti	ti
tilde	tilde
tileH	tile-h
tileW	tile-w
tileX	tile-x
tileY	tile-y
tiles	tiles
time0	time-0
time1	time-1
time2	time-2
timeLeft	time-left
timeToday	time-today
timeV	time-v
timer	timer
timerKey	timer-key
times	times
timestampTokenInfo	timestamp-token-info
tinfo	tinfo
titleLabel	title-label
titleString	title-string
titleTags	title-tags
tj	tj
tk	tk
tl	tl
tm	tm
tmpCanonical	tmp-canonical
tmpErr	tmp-err
tmpExt	tmp-ext
tmpGrammar	tmp-grammar
tmpImg	tmp-img
tmpJar	tmp-jar
tmpKey	tmp-key
tmpLen	tmp-len
tmpMB2	tmp-mb2
tmpOuterJoinsAfterWhere	tmp-outer-joins-after-where
tmpRect	tmp-rect
tmpUpper	tmp-upper
tn	tn
to	to
toCancel	to-cancel
toDate	to-date
toDispatch	to-dispatch
toElementLength	to-element-length
toExpand	to-expand
toName	to-name
toRepositoryFile	to-repository-file
tobeIgnored	to-be-ignored
tohFactory	toh-factory
tokenFilter	token-filter
tokenProperties	token-properties
tokenTypeToLanguage	token-type-to-language
tokend	token-d
tokens	tokens
toklen	tok-len
toolKind	tool-kind
toolVisualizers	tool-visualizers
toolset	toolset
topCenterSize	top-center-size
topLabel	top-label
topStackNode	top-stack-node
torrent	torrent
totalOptimized	total-optimized
total_cache	total-cache
total_copied	total-copied
totallen	total-len
totalmem	total-mem
tp	tp
tpList	tp-list
tq	tq
tr	tr
traceRemoveWhat	trace-remove-what
trace_file	trace-file
tracingExecutor	tracing-executor
trailingRunLength	trailing-run-length
transaction_id	transaction-id
transcode_file	transcode-file
transferFilter	transfer-filter
treePathHandlesFromLookup	tree-path-handles-from-lookup
triggerDefinition	trigger-definition
triggerLength	trigger-length
trimEntry	trim-entry
ts	ts
tstring	t-string
tt	tt
ttags	t-tags
ttarg	tt-arg
ttask	t-task
ttcprtOp	ttcprt-op
tu	tu
tunnels	tunnels
tv	tv
tw	tw
twClazz	tw-clazz
tx	tx
ty	ty
typeArgument	type-argument
typeCallContext	type-call-context
typeElementHandle	type-element-handle
typeEnumMap	type-enum-map
typeNameLen	type-name-len
typeVariableScope	type-variable-scope
tz	tz
u	u
u0	u-0
u1	u-1
u2	u-2
u3	u-3
u4	u-4
u8	u-8
uBound	u-bound
uI	u-i
uL	u-l
uN	u-n
uR	u-r
ua	ua
ub	ub
uboundStr	ubound-str
uc	uc
ud	ud
ue	ue
ueright	ue-right
uf	uf
ug	ug
uh	uh
ui	ui
uinames	ui-names
uj	uj
uk	uk
ul	ul
ul_limit_seed	ul-limit-seed
ullMin	ull-min
um	um
umlPackage	uml-package
un	un
unArchiver	un-archiver
unbound	unbound
unboxed	unboxed
uncheckedPeers	unchecked-peers
uncompressedLen	uncompressed-len
uncompressedLength	uncompressed-length
undeclaredExceptions	undeclared-exceptions
undoEditArray	undo-edit-array
unenlisted	unenlisted
uniqueTypeNames	unique-type-names
unitsIndex	units-index
unitsLength	units-length
unloadMark	unload-mark
unrecognized	unrecognized
unregistryOldAttributeActionPair	unregistry-old-attribute-action-pair
unstrippedName	unstripped-name
uo	uo
up	up
upPriorities	up-priorities
update	update
updateActivatedNodes	update-activated-nodes
updateAvail	update-avail
updateCache	update-cache
updateHtables	update-htables
updateThreadSize	update-thread-size
updatedPoolName	updated-pool-name
updatedRowCtx	updated-row-ctx
upgradejarpath	upgrade-jar-path
upperBoundVal	upper-bound-val
upperMessage	upper-message
uq	uq
ur	ur
uriresolver	uri-resolver
urlLabel	url-label
urlPort	url-port
us	us
usableKey	usable-key
usageSA	usage-sa
usageType	usage-type
useDefaultProxy	use-default-proxy
useExponent	use-exponent
useGridLayout	use-grid-layout
useReqLimitingPrios	use-req-limiting-prios
useScale2	use-scale-2
useScrollableResultSetToSkip	use-scrollable-result-set-to-skip
useSooner	use-sooner
useStoredBounds	use-stored-bounds
useThisAccess	use-this-access
useURI	use-uri
useVal	use-val
useprWin	usepr-win
userEntries	user-entries
userPropsFile	user-props-file
userSpecifedResolverSetting	user-specifed-resolver-setting
user_bytes	user-bytes
usersVector	users-vector
ut	ut
uu	uu
uv	uv
uw	uw
ux	ux
uy	uy
uz	uz
v	v
v0	v-0
v1	v-1
v2	v-2
v3	v-3
v4	v-4
v6	v-6
v6_ok	v6-ok
vA	v-a
vB	v-b
vC	v-c
vI	v-i
vS	v-s
v_	v
va	va
vaca	vaca
vadj	v-adj
val1	val-1
val2	val-2
val3	val-3
val4	val-4
valS	vals
validCell	valid-cell
validExceptions	valid-exceptions
validToDate	valid-to-date
validateCookieImpl	validate-cookie-impl
validationResult	validation-result
validationStatusValue	validation-status-value
vals	vals
valueKeyType	value-key-type
valueVariable	value-variable
values3456	values-3456
valuesArray	values-array
valuesFilter	values-filter
var1	var-1
var2	var-2
var3	var-3
varData	var-data
varFinder	var-finder
varN	var-n
varUnderTest	var-under-test
vare	vare
varg	varg
variableAttributeName	variable-attribute-name
variableDeclarationFragment	variable-declaration-fragment
variableExisted	variable-existed
variableModifierLabel	variable-modifier-label
variableSizedBlocks	variable-sized-blocks
variablesView	variables-view
variantContainer	variant-container
varr	varr
vars	vars
varstack	var-stack
vary	vary
vb	vb
vbar	vbar
vc	vc
vc50	vc-50
vd	vd
ve	ve
vectorIndex	vector-index
vegetarianColumn	vegetarian-column
verifierSupport	verifier-support
verifyLF	verify-lf
versionStream	version-stream
vf	vf
vfsClass	vfs-class
vg	vg
vh	vh
vhost	vhost
vi	vi
viewBackground	view-background
viewIDs	view-ids
viewIds	view-ids
viewKey	view-key
viewLength	view-length
viewPaneControl	view-pane-control
viewTitleInfo	view-title-info
virtualPosition	virtual-position
visibilityCode	visibility-code
visibleRow	visible-row
visibleStr	visible-str
vk	vk
vl	vl
vm	vm
vmMethodName	vm-method-name
vmStandin	vm-standin
vmargin	v-margin
vmver	vmver
vn	vn
vp	vp
vq	vq
vr	vr
vs	vs
vt	vt
vtiClass	vti-class
vu	vu
vv	vv
vw	vw
vx	vx
vy	vy
vz	vz
w	w
w0	w-0
w1	w-1
w2	w-2
w3	w-3
w4	w-4
w5	w-5
w6	w-6
w7	w-7
w8	w-8
w9	w-9
wA	wa
wAdd	w-add
wApp	w-app
wB	w-b
wF	w-f
wH	w-h
w_	w
wa	wa
wadlDataObject	wadl-data-object
wakeupReason	wakeup-reason
warArchive	war-archive
warnX	warn-x
warningToElement	warning-to-element
wasDefaultVar	was-default-var
wasErrorStateB	was-error-state-b
wasEx	was-ex
wasRi	was-ri
wasSet	was-set
watchFolderPathParameter	watch-folder-path-parameter
wb	wb
wc	wc
wd	wd
we	we
weakLookup	weak-lookup
webAppLbl	web-app-lbl
webAppl	web-appl
webApps	web-apps
webDocbaseDirRes	web-doc-base-dir-res
webFileText	web-file-text
webRootPath	web-root-path
webServiceProvider	web-service-provider
webSources	web-sources
webXmlUrlString	web-xml-url-string
webappLocation	web-app-location
weights	weights
wf	wf
wh	wh
whenValue	when-value
whitePieces	white-pieces
wi	wi
widthInt	width-int
wildName	wild-name
wildcardIdx	wildcard-idx
winErrnos	win-errnos
withLoader	with-loader
withThis	with-this
wj	wj
wk	wk
wl	wl
wm	wm
wn	wn
wo	wo
womStamp	wom-stamp
wordSets	word-sets
workspaceModelBase	workspace-model-base
wp	wp
wr	wr
wrappedException	wrapped-exception
wrappedJspApplicationContextImpl	wrapped-jsp-application-context-impl
wrapperLifecycles	wrapper-lifecycles
ws	ws
wsContext	ws-context
wsNode	ws-node
wsdlModelProvider	wsdl-model-provider
wt	wt
wu	wu
wv	wv
ww	ww
wx	wx
wy	wy
x	x
x0	x-0
x1	x-1
x1IndicatorOfs	x1-indicator-ofs
x2	x-2
x3	x-3
x4	x-4
x5	x-5
x6	x-6
x7	x-7
x8	x-8
x9	x-9
xBorderSize	x-border-size
xC	x-c
xMarkStringNoMillis	x-mark-string-no-millis
xN	x-n
xP	x-p
xS	x-s
xa	xa
xb	xb
xc	xc
xd	xd
xdmElement	xdm-element
xdmNode	xdm-node
xe	xe
xf	xf
xgcCopy	xgc-copy
xh	xh
xhtmlPreFingerprint	xhtml-pre-fingerprint
xi	xi
xl	xl
xm	xm
xmlHandler	xml-handler
xmlJspTagDatasList	xml-jsp-tag-datas-list
xmlReportFiles	xml-report-files
xn	xn
xo	xo
xorKey	xor-key
xp	xp
xr	xr
xs	xs
xsdFolder	xsd-folder
xsdNS	xsd-ns
xstringFactory	x-string-factory
xt	xt
xu	xu
xv	xv
xw	xw
xx	xx
xy	xy
xyzSeriesArray	xyz-series-array
xz	xz
y	y
y0	y-0
y1	y-1
y2	y-2
y3	y-3
y4	y-4
y5	y-5
y6	y-6
yC	y-c
yClient	y-client
yN	y-n
yP	y-p
yS	y-s
y_word	y-word
ya	ya
yb	yb
yc	yc
yd	yd
ye	ye
yf	yf
yh	yh
yi	yi
yl	yl
ym	ym
yn	yn
yo	yo
yp	yp
yr	yr
ys	ys
yt	yt
yv	yv
yw	yw
yy	yy
yz	yz
z	z
z0	z-0
z1	z-1
z2	z-2
z3	z-3
z4	z-4
z5	z-5
zX	zx
zY	zy
za	za
ze	ze
zeroNew	zero-new
zeroPad	zero-pad
zeroPos	zero-pos
zeroRGB	zero-rgb
zf	zf
zh	zh
zi	zi
zipfileset	zip-file-set
zj	zj
zm	zm
zn	zn
zo	zo
zp	zp
zr	zr
zs	zs
zt	zt
zv	zv
zw	zw
zx	zx
zy	zy
zz	zz
