AALCDVRGB	aal-cdv-rgb
ABBREVIATE	abbreviate
ABORTING	aborting
ABOUTMSG	about-msg
ABSOLUTE	absolute
ABSTRACT	abstract
ABSTRACTNODE	abstract-node
ACCESSIBLE	accessible
ACKNOWLEDGEMENTINTERVAL	acknowledgement-interval
ACTIVATIONCONFIGPROPERTYVALUEID	activation-config-property-value-id
ACTIVATIONFILE	activation-file
ACTIVERECORD	active-record
ADDRESSINGMETADATA	addressing-metadata
ADDRVIEWSIZE	addr-view-size
ADJUSTTIMER	adjust-timer
ADMINISTRATOR	administrator
ADVANCED	advanced
ADVICEEXECUTION	advice-execution
AGGREGATE	aggregate
ALLFROMNODE	all-from-node
ALLOCATING	allocating
ALLOCATION	allocation
ALLOWDUPLICATES	allow-duplicates
ALLRESULTS	all-results
ALLWILDCARD	all-wildcard
ALTERNATIVE	alternative
ALTORENDSTATE	alt-or-end-state
AMBIGUOUS	ambiguous
ANCESTOR	ancestor
ANCESTORHASXMLNS	ancestor-has-xmlns
ANCESTORNOXMLNS	ancestor-no-xmlns
ANEWARRAY	a-new-array
ANNOTATIONS	annotations
ANONCONSTR	anon-constr
ANYTHING	anything
APPLICATION	application
APPLICATIONS	applications
APPOINTMENT	appointment
AQUAMARINE	aquamarine
ARGAUXILIARYNODE	argauxiliary-node
ARRAYNODE	array-node
ARTIFACTS	artifacts
ASGRSHIFT	asg-rshift
ASGURSHIFT	asg-urshift
ASKCLEAR	ask-clear
ASSIGNMENTS	assignments
ASSOCIATED	associated
ASTEJBQL	ast-ejb-ql
ASYMMETRICBINDING	asymmetric-binding
ATALWAYSCAPABILITY	at-always-capability
ATTRASSIGNNODE	attr-assign-node
ATTREMPTY	attr-empty
ATTRIBUTE	attribute
AUDIOCHAT	audio-chat
AUTHORITATIVE	authoritative
AUTOBOXING	auto-boxing
AUTOCOMMIT	auto-commit
AUTOLOAD	auto-load
AUTOSENSE	auto-sense
AUTOSPEC	auto-spec
AUTOWIRE	auto-wire
BACKENDPRINCIPALPASSWORD	backend-principal-password
BACKGROUNDCOLOR	background-color
BACKREFERENCE	back-reference
BACKREFNODE	back-ref-node
BACKSLASH	back-slash
BATCHSIZE	batch-size
BEANCOMP	bean-comp
BEANINFO	bean-info
BEFOREFIRST	before-first
BIGDECIMAL	big-decimal
BIGNUMNODE	big-num-node
BINARIES	binaries
BINDPROP	bind-prop
BINPERSID	bin-pers-id
BINUNICODE	bin-unicode
BLANKCOMMENT	blank-comment
BLOBCREATELOCATOR	blob-create-locator
BLOBTRUNCATE	blob-truncate
BLOCKBODY	block-body
BLOCKNODE	block-node
BLOCKSHIFT	block-shift
BLUECOMPONENT	blue-component
BOARDINFO	board-info
BOOLEANS	booleans
BOOTCLASSPATH	boot-classpath
BOOTSTRAPPOLICY	bootstrap-policy
BORDERONLY	border-only
BREAKNODE	break-node
BRIGHTER	brighter
BROADCAST	broadcast
BUFFEREDFILESIZE	buffered-file-size
BUFFERLEN	buffer-len
BUNDLEEVENTSYNC	bundle-event-sync
BUNDLEVALUE	bundle-value
BYTESPEROP	bytes-per-op
CACHEONMATCH	cache-on-match
CALLABLE	callable
CALLBACKHANDLER	callback-handler
CALLSUPER	call-super
CAPACITY	capacity
CAPTIONMARGINS	caption-margins
CASENODE	case-node
CERTALIAS	cert-alias
CERTIFICATE	certificate
CHANGEABLE	changeable
CHANNELPOOLSIZE	channel-pool-size
CHARNORMALIZE	char-normalize
CHARTREUSE	chartreuse
CHECKCAST	check-cast
CHECKEDIN	checked-in
CHECKMARKNORMAL	checkmark-normal
CHECKPARAMETERS	check-parameters
CHEROKEE	cherokee
CHKSUMLEN	chk-sum-len
CLASSCLASSES	class-classes
CLASSFILE	class-file
CLASSINSTANCE	class-instance
CLASSLOADER	class-loader
CLASSSTATIC	class-static
CLASSVARASGNNODE	class-var-asgn-node
CLASSVARDECLNODE	class-var-decl-node
CLEARING	clearing
CLIENTCERT	client-cert
CLIPCLAMP	clip-clamp
CLOBGETSUBSTRING	clob-get-substring
CLOBSETSTRING	clob-set-string
CMDATHRM	cmd-athrm
CMDBEGIN	cmd-begin
CMDCHKRM	cmd-chk-rm
CMDCMPRM	cmd-cmp-rm
CMDVLTRM	cmd-vltrm
CMNTCPIP	cmn-tcpip
CMPENGINEFACTORY	cmp-engine-factory
CMRFIELDNAMEID	cmr-field-name-id
CODEELEMENT	code-element
CODEPOINTMASK	code-point-mask
COLGROUP	col-group
COLLECTIONS	collections
COLONCOLON	colon-colon
COLORPRINT	color-print
COLUMNSIZE	column-size
COMBINED	combined
COMMENTED	commented
COMPAREPREV	compare-prev
COMPILATIONUNIT	compilation-unit
COMPILED	compiled
COMPILEMODE	compile-mode
COMPILER	compiler
COMPLETED	completed
COMPLEXREGION	complex-region
COMPOSITE	composite
COMPOUND	compound
COMPRESSMOVE	compress-move
CONCATENATING	concatenating
CONCURRENT	concurrent
CONDITIONALSUBITEM	conditional-sub-item
CONFIGERR	config-err
CONNECTIONDEFINITIONNAME	connection-definition-name
CONNECTORS	connectors
CONSISTENCY	consistency
CONSTNODE	const-node
CONSTRAINT	constraint
CONSTRAINTFIELDVALUECACHEONMATCH	constraint-field-value-cache-on-match
CONSTRAINTFIELDVALUECACHEONMATCHFAILURE	constraint-field-value-cache-on-match-failure
CONSTRUCTORS	constructors
CONTAINMENT	containment
CONTAINS	contains
CONTENTYPE	contentype
CONTEXTUALIZED	contextualized
CONTINUE	continue
CONTRIBUTED	contributed
CONTRIBUTOR	contributor
CONVERTING	converting
COOKIESDATA	cookies-data
COUNTERCW	counter-cw
COUNTRIES	countries
CPPINCLUDE	cpp-include
CRAZYHOUSE	crazy-house
CREDENTIALDELEGATION	credential-delegation
CROSSJOIN	cross-join
CUMULATIVE	cumulative
CURRENCYSTYLE	currency-style
CUSTOMIZER	customizer
CUSTOMIZERCLASS	customizer-class
CVPERCENT	cv-percent
DARKBLUE	dark-blue
DASHMATCH	dash-match
DATABASEURL	database-url
DATABINDING	data-binding
DATAFILE	data-file
DATAHANDLER	data-handler
DATALINK	data-link
DATARACES	data-races
DATASIZE	data-size
DATASOURCE	data-source
DATASOURCECLASSNAME	data-source-class-name
DATATYPE	data-type
DDBEANED	dd-beaned
DEACTIVATED	deactivated
DEBUGGER	debugger
DECENDING	decending
DECLARATION	declaration
DECLARATIONAL	declarational
DECLARATIONS	declarations
DECLARED	declared
DECODABET	decod-abet
DECORATE	decorate
DEFAULTED	defaulted
DEFAULTGOAL	default-goal
DEFAULTMODEL	default-model
DEFAULTS	defaults
DEFAULTSACCESSABLE	defaults-accessable
DEFAULTSERVERDEF	default-server-def
DEFINITION	definition
DEFINITIONS	definitions
DEFLATED	deflated
DEFPROMPT	def-prompt
DEFSNODE	defs-node
DELEGATE	delegate
DELIVERABLE	deliverable
DENSEFORWARDSLASH	dense-forward-slash
DEPARTMENTS	departments
DEPENDENCY	dependency
DEPGOALS	dep-goals
DEPRECATION	deprecation
DERBYNETCLIENT	derby-net-client
DESCENDANTSORSELFFROMROOT	descendants-or-self-from-root
DESCENDING	descending
DESCRIPTION	description
DESCRIPTIONS	descriptions
DESCRIPTOR	descriptor
DESCRIPTORS	descriptors
DESKTOPDIRECTORY	desktop-directory
DESTRUCTOR	destructor
DETERMINISTIC	deterministic
DEVELOPER	developer
DIAMONDCIRCLED	diamond-circled
DIFFERENCE	difference
DIFFERENT	different
DIFFERING	differing
DIGESTALGORITHM	digest-algorithm
DIRECTION	direction
DIRECTIVE	directive
DISABLEDPUSHED	disabled-pushed
DISABLESTREAMINGSECURITY	disable-streaming-security
DISCONNECTEDICONBASE	disconnected-icon-base
DISCONTINUOUS	discontinuous
DISCOVERED	discovered
DISPATCH	dispatch
DOCLETPATH	doclet-path
DOCUMENTED	documented
DOMCLASSFILE	dom-class-file
DOMINATES	dominates
DONEBITS	done-bits
DONOTDOWNLOAD	do-not-download
DONTENUM	dont-enum
DOTDOTDOT	dot-dot-dot
DOWNHOVER	down-hover
DOWNLOADS	downloads
DOWNLOADSITE	download-site
DOWNPOINTER	down-pointer
DOWNPOINTERCIRCLED	down-pointer-circled
DREGEXPNODE	d-regex-p-node
DRIVERDESC	driver-desc
DSCSQLSTT	dsc-sql-stt
DUCKABLE	duckable
DUMPBEANTREE	dump-bean-tree
DUMPTREE	dump-tree
DVARNODE	d-var-node
EARLIESTBEGIN	earliest-begin
EBACKGROUND	e-background
EJBRELATIONNAMEID	ejb-relation-name-id
EJBRELATIONSHIPROLENAMEID	ejb-relationship-role-name-id
EKERNING	e-kerning
ELEMWILDCARD	elem-wildcard
ELIGATURES	e-ligatures
EMAILSERVER	email-server
EMBEDATTRIBUTESTAG	embed-attributes-tag
EMBEDPARAMTAG	embed-param-tag
EMPTYITERATOR	empty-iterator
EMULATED	emulated
ENABLETLS	enable-tls
ENABLING	enabling
ENCLOSING	enclosing
ENCRYPTED	encrypted
ENDDEBUG	end-debug
ENDORSINGENCRYPTEDSUPPORTINGTOKENS	endorsing-encrypted-supporting-tokens
ENDORSINGSUPPORTINGTOKENS	endorsing-supporting-tokens
ENDUOWRM	end-uowrm
ENQUEUED	enqueued
ENTERPRISE	enterprise
ENVIRONMENT	environment
EPOSTURE	e-posture
EPROTONOSUPPORT	e-proto-no-support
EQUALEQUAL	equal-equal
EQUIVALENT	equivalent
ERRORCOLOUR	error-colour
ERRORICON	error-icon
ESCXMLTEXT	esc-xml-text
ESTABLISHED	established
ESTIMATED	estimated
ESTRIKETHROUGH	e-strikethrough
ESUPERSCRIPT	e-superscript
ETIMEDOUT	e-timed-out
ETRACKING	e-tracking
EUROPEAN	european
EXCEEDED	exceeded
EXCLUDED	excluded
EXCLUDES	excludes
EXCLUSIONS	exclusions
EXCPETION	excpetion
EXECGOALS	exec-goals
EXECUTABLES	executables
EXECUTING	executing
EXECUTION	execution
EXECUTIVE	executive
EXPANDCHARINDEX	expand-char-index
EXPONENT	exponent
EXTASCII	ext-ascii
EXTENDED	extended
EXTENDERS	extenders
EXTRACTION	extraction
EXTUSERINFO	ext-user-info
FAILALLCONNECTIONS	fail-all-connections
FAKENAMESUFFIX	fake-name-suffix
FASTCHECKPARAMETERS	fast-check-parameters
FDODSCOFF	fdo-dsc-off
FDOTRPOFF	fdo-trp-off
FIGURESP	figures-p
FILECHARS	file-chars
FILENAMES	file-names
FILESOURCE	file-source
FILLCOLOR	fill-color
FILTERED	filtered
FILTEREDLIST	filtered-list
FILTERING	filtering
FINALIZE	finalize
FINALNAME	final-name
FINDATTR	find-attr
FINISHEDLATE	finished-late
FIRSTCOLUMN	first-column
FIRSTPOS	first-pos
FIXNUMNODE	fix-num-node
FKPOSITION	fk-position
FKPOSITIONDESC	fk-position-desc
FKREFERREDCOLUMNDESC	fk-referred-column-desc
FKREFERRINGTABLE	fk-referring-table
FKREFERRINGTABLEDESC	fk-referring-table-desc
FLIPNODE	flip-node
FONTCACHEMASK	font-cache-mask
FOREACHLOOP	foreach-loop
FORMCTRL	form-ctrl
FORMFEED	form-feed
FORMSOURCE	form-source
FORWARDSLASH	forward-slash
FOUNDNODE	found-node
FRAMEBITS	frame-bits
FRAMEWORKS	frameworks
FREEFORM	free-form
FROMSTANDARD	from-standard
FULFILLING	fulfilling
FUNCSCOPE	func-scope
FUNCTION	function
GCPPFILT	gcpp-filt
GDSCHAIN	gds-chain
GENERATED	generated
GENERATEDELEGATOR	generate-delegator
GENERATEHASCHANGED	generate-has-changed
GENERATEPARENTREFS	generate-parent-refs
GENERATEVALIDATE	generate-validate
GENERATION	generation
GENERATOR	generator
GETCLASS	get-class
GETEJBHOME	get-ejb-home
GETFIELD	get-field
GETMETHOD	get-method
GETPROPNOWARN	get-prop-no-warn
GETPROTO	get-proto
GETSCOPEPARENT	get-scope-parent
GIVENNAME	given-name
GLOBALASGNNODE	global-asgn-node
GLOBALVARNODE	global-var-node
GOLDENROD	goldenrod
GREATEST	greatest
GROOVYCOMMENT	groovy-comment
GROWABLE	growable
HARDNESS	hardness
HASHCODE	hash-code
HASHNODE	hash-node
HASHPRIME	hash-prime
HASHSTEP	hash-step
HEADEREND	header-end
HEADERMAGIC	header-magic
HEADPHONE	head-phone
HEARTBEAT	heartbeat
HEAVYDOTTED	heavy-dotted
HEAVYVERTICALSTRIPE	heavy-vertical-stripe
HIERARCHY	hierarchy
HIGHEDGE	high-edge
HIGHLIGHT	highlight
HIGHLIGHTED	highlighted
HISTORYFILE	history-file
HORIZONTAL	horizontal
HORIZONTALSTRIPE	horizontal-stripe
HTTPCONTEXT	http-context
HTTPEQUIV	http-equiv
HYPEREDGE	hyper-edge
HYPERLINK	hyperlink
ICONBASE	icon-base
ICONDOWN	icon-down
ICONPRESSED	icon-pressed
ICONSORTEDHOT	icon-sorted-hot
ICONSORTEDPRESSED	icon-sorted-pressed
IDENTIFIER	identifier
IDENTITYDB	identity-db
IDEOGHAPHICS	ideoghaphics
IFNONNULL	if-non-null
IGNORABLEMASK	ignorable-mask
IGNORABLEWS	ignorable-ws
IMAGEABORTED	image-aborted
IMPLEMENTATION	implementation
IMPLEMENTATIONID	implementation-id
IMPLEMENTORS	implementors
IMPLICIT	implicit
IMPORTDECLARATION	import-declaration
IMPORTED	imported
IMPORTKEYSTORE	import-key-store
INACTIVEPUSHED	inactive-pushed
INACTIVITYTIMEOUT	inactivity-timeout
INADDRSZ	in-addrs-z
INCLUDED	included
INCLUDES	includes
INCLUDING	including
INCLUSIVEOR	inclusive-or
INCOMING	incoming
INCREMENT	increment
INDENTAMOUNT	indent-amount
INDEPENDENT	independent
INDEXABLE	indexable
INDICATOR	indicator
INDICATORS	indicators
INDIRECT	indirect
INFOICON	info-icon
INFORMATION	information
INFORMIX	informix
INHERITABLE	inheritable
INHERITANCE	inheritance
INHERITED	inherited
INITIALISING	initialising
INITIALIZATION	initialization
INITIALIZE	initialize
INITIALTABLESIZE	initial-table-size
INLINENEWINSTANCE	inline-new-instance
INLINING	inlining
INNERJOIN	inner-join
INPARAMPENDING	in-param-pending
INPROGRESS	in-progress
INPUTURI	input-uri
INSENSITIVE	insensitive
INSTALLATIONS	installations
INSTALLED	installed
INSTALLER	installer
INSTANCELIMIT	instance-limit
INSTANCEOF	instance-of
INSTANCES	instances
INSTANCIES	instancies
INSTVARNODE	inst-var-node
INTARRAY	int-array
INTERFACE	interface
INTERFACES	interfaces
INTERPRETER	interpreter
INTERVALS	intervals
INTROCOUNT	intro-count
INTRODUCTION	introduction
INTVALUE	int-value
INVALIDATED	invalidated
INVISIBLE	invisible
INVOKEINTERFACE	invoke-interface
INVOKESETUP	invoke-setup
INVOKESTATIC	invoke-static
IPVERSION	ip-version
ISBEFOREFIRST	is-before-first
ISISOLATIONLEVELGUARANTEED	is-isolation-level-guaranteed
ISOLATION	isolation
ISOWKNUMBER	is-owk-number
ITERATIONS	iterations
ITERATORS	iterators
JAPANESE	japanese
JAVAGOALS	java-goals
JAVAMAIL	java-mail
JUSTIFIED	justified
JUSTIFIES	justifies
KASRATAN	kasratan
KEYCLONE	key-clone
KEYFIELDSCOPE	key-field-scope
KEYPASSWORD	key-password
KEYSTORE	key-store
LABRACKET	la-bracket
LAMBDANODE	lambda-node
LANDSCAPE	landscape
LASTLINE	last-line
LAUNCHERS	launchers
LAXTSFIRST	la-xts-first
LAXTSLAST	la-xts-last
LEFTBRACKET	left-bracket
LEFTMARGIN	left-margin
LEFTNORMAL	left-normal
LIBSUFFIX	lib-suffix
LIFECYCLE	lifecycle
LIGATURES	ligatures
LINEFEED	line-feed
LINEMODE	line-mode
LINENUMBERS	line-numbers
LINKAFTER	link-after
LISTFONT	list-font
LIVECONNECT	live-connect
LOADSTARTED	load-started
LOCALNAMEMAPENTRY	local-name-map-entry
LOCALSERVANT	local-servant
LOCALVARIABLE	local-variable
LOCATION	location
LOCKNAME	lock-name
LOCKTYPE	lock-type
LOGTESTLISTENEREVENTS	log-test-listener-events
LONGVARBINARY	long-var-binary
LOOKUPLENGTH	lookup-length
LOOKUPSWITCH	lookup-switch
LSHAREDDATA	l-shared-data
LSQBRACKET	lsq-bracket
LVERSION	l-version
MACRODEF	macro-def
MAGICLEN	magic-len
MAINTENANCEINTERVAL	maintenance-interval
MALFORMED	malformed
MANAGERDATA	manager-data
MANUALLY	manually
MARKEDFORSWEEP	marked-for-sweep
MAVENSUREFIREDEBUG	maven-surefire-debug
MAXARGSIZE	max-arg-size
MAXCANVAS	max-canvas
MAXCLOCKSKEW	max-clock-skew
MAXCOPIES	max-copies
MAXGRAYLENGTH	max-gray-length
MAXHISTORY	max-history
MAXLENGTH	max-length
MAXNUMRECENTANALYSES	max-num-recent-analyses
MAXRECEIVEBUFFERSIZE	max-receive-buffer-size
MAXRECENT	max-recent
MAXREPLY	max-reply
MAXRSLCNT	max-rsl-cnt
MAXUNICODE	max-unicode
MAXWIDTH	max-width
MBEANSERVERDELEGATE	mbean-server-delegate
MEDIUMINT	medium-int
MESSAGELISTENERINTERFACE	message-listener-interface
MESSAGES	messages
METADATAREFERENCE	metadata-reference
METHODNAME	method-name
METHODVALUE	method-value
MGRDEPRM	mgr-dep-rm
MICROPHONE	microphone
MIMEEXTENSION	mime-extension
MINALLOCATED	min-allocated
MINEXCLUSIVE	min-exclusive
MINFEATURES	min-features
MINIMIZE	minimize
MININCLUSIVE	min-inclusive
MINLENGTH	min-length
MINORNUMBERMAX	minor-number-max
MINSTRIKES	min-strikes
MINUSMINUS	minus-minus
MINWIDTH	min-width
MODELVERSION	model-version
MODENAME	mode-name
MODIFIERS	modifiers
MODULARITY	modularity
MODULEURI	module-uri
MONGOLIAN	mongolian
MONITORDATA	monitor-data
MONITORRD	monitor-rd
MONTHVIEWFONT	month-view-font
MOVECASE	move-case
MULTIANEWARRAY	multi-a-new-array
MULTIPLE	multiple
MULTIPLICITY	multiplicity
MULTIPLIER	multiplier
MULTIPLY	multiply
MULTISELECTABLE	multi-selectable
MUSTSUPPORTREFISSUERSERIAL	must-support-ref-issuer-serial
MUSTSUPPORTREFKEYIDENTIFIER	must-support-ref-key-identifier
MYTYPENAME	my-type-name
NAMEANDTYPE	name-and-type
NAMESPACEURI	namespace-uri
NANOSECOND	nanosecond
NARROWOOP	narrow-oop
NATTRIBUTES	n-attributes
NEEDSCOMMIT	needs-commit
NEEDSUPDATE	needs-update
NEGATION	negation
NEGATIVE	negative
NEGATIVELOOKAHEAD	negative-look-ahead
NETSCAPE	netscape
NEWARRAY	new-array
NEWFROMNAME	new-from-name
NEWHEADER	new-header
NEWINSTANCE	new-instance
NEWVALUE	new-value
NEXTTOKEN	next-token
NOANCHOR	no-anchor
NOCLASSES	no-classes
NODENAME	node-name
NODEPRECATED	no-deprecated
NOMARKER	no-marker
NONASCII	non-ascii
NONBLOCK	non-block
NONSORTED	non-sorted
NONSOURCE	non-source
NONTERMINAL	non-terminal
NONTRANSACTIONALCONNECTIONS	non-transactional-connections
NONWORKINGDAY	non-working-day
NOOUTERTHIS	no-outer-this
NORESIZE	no-resize
NORMALIZED	normalized
NORMALIZER	normalizer
NORTHHOMEPLATE	north-home-plate
NOTEQUALS	note-quals
NOTIFYCHG	notify-chg
NOTIFYREM	notify-rem
NTHREFNODE	nth-ref-node
NULLDATA	null-data
NULLDESC	null-desc
NULLFIELDSTRATEGY	null-field-strategy
NULLPARAMS	null-params
NUMBERNOS	number-nos
NUMBERSTYLE	number-style
NUMCHILDREN	num-children
NUMERATOR	numerator
OBJBLOCK	obj-block
OBJECTCLASS	object-class
OBJECTLIT	object-lit
OBJECTNAME	object-name
OBJECTTYPE	object-type
OBJLITNAME	obj-lit-name
OBSERVER	observer
OFFSETBITS	offset-bits
OMGVMCID	omg-vmc-id
ONCONTEXTMENU	on-context-menu
ONDBLCLICK	on-dbl-click
ONSCROLL	on-scroll
OPELEMENTASGNNODE	op-element-asgn-node
OPENINBROWSER	open-in-browser
OPERATION	operation
OPERATORS	operators
OPNQFLRM	opnqflrm
OPTIMIZEDMIMESERIALIZATION	optimized-mime-serialization
ORDERING	ordering
ORGREATER	or-greater
OTHERTEXT	other-text
OTSHOOKEXCEPTION	ots-hook-exception
OUTBOUND	out-bound
OUTLINEABLECHUNKEND	outlineable-chunk-end
OUTLINEABLECHUNKSTART	outlineable-chunk-start
OUTOVRANY	out-ovr-any
OUTOVRFRS	out-ovr-frs
OUTOVROPT	out-ovr-opt
OUTPUTDIRECTORY	output-directory
OUTPUTINPUT	output-input
OVERFLOW	overflow
OVERHEAD	overhead
OVERLAPP	overlap-p
OVERLAPPED	overlapped
OVERLINE	over-line
OVERRIDE	override
OVERRIDES	overrides
OVERTYPE	over-type
OVERVIEWSTATUS	overview-status
OVERWRITE	overwrite
PACKAGED	packaged
PACKAGEFRAGMENT	package-fragment
PACKAGES	packages
PADDEDWIDTH	padded-width
PADDINGS	paddings
PAGESIZE	page-size
PARAMETER	parameter
PARAMETERENCODINGFORMHINTFIELD	parameter-encoding-form-hint-field
PARAMETERIZED	parameterized
PARAMSTATE	param-state
PARANOIA	paranoia
PARENTSMIXIN	parents-mix-in
PARSERCLASSFILEPATH	parser-class-file-path
PARTITION	partition
PARTITIONS	partitions
PASSIVATED	passivated
PASSIVATOR	passivator
PASSWORD	password
PERCENTEQ	percent-eq
PERCENTS	percents
PEROBJECT	per-object
PERSISTENCE	persistence
PERSISTENCETYPE	persistencetype
PERTYPEWITHIN	per-type-within
PETABYTE	peta-byte
PINGINFO	ping-info
PKGBNARM	pkg-bnarm
PKGBPARM	pkg-b-parm
PKGNAMCSN	pkg-nam-csn
PLACEHOLDERDURATION	placeholder-duration
PLACEHOLDERSTART	placeholder-start
PLANESHIFT	plane-shift
PLANNING	planning
PLUSPLUS	plus-plus
POLLREMOVE	poll-remove
POLLWRBAND	poll-wr-band
POOLSIZE	pool-size
POSITIONDESC	position-desc
POSITIONS	positions
POSSIBLE	possible
POSTFIXES	post-fixes
PRECEDINGANDANCESTOR	preceding-and-ancestor
PRECEDINGSIBLING	preceding-sibling
PRECHECK	pre-check
PRECONFIGUREDSTS	preconfigured-sts
PRECREATED	pre-created
PREDICATE	predicate
PREEXENODE	pre-exe-node
PREINDEXED	pre-indexed
PREINDEXING	pre-indexing
PREINITIALIZATION	pre-initialization
PREREQUISITES	prerequisites
PREVCOMMENTSSIZE	prev-comments-size
PRIMARYORDERINCREMENT	primary-order-increment
PRIMARYORDERSHIFT	primary-order-shift
PRIMKEYFIELDID	prim-key-field-id
PRINCIPALNAMECLASSNAME	principal-name-class-name
PRINTERS	printers
PRINTHOOD	print-hood
PRINTING	printing
PROBABLY	probably
PROBLEMS	problems
PROCEDURE	procedure
PROCESSDOCTYPE	process-doc-type
PROCESSING	processing
PROFILES	profiles
PROGRAMMATIC	programmatic
PROGRAMS	programs
PROGRESS	progress
PROJECTS	projects
PROJECTSUMMARY	project-summary
PROPAGATION	propagation
PROPERTYEDITORCLASS	property-editor-class
PROPERTYNAME	property-name
PROPERTYPUT	property-put
PROPRIETARY	proprietary
PRORATED	prorated
PROTECTION	protection
PROTECTIONTOKEN	protection-token
PROTECTTOKENS	protect-tokens
PROTOTYPE	prototype
PROVIDED	provided
PROVIDER	provider
PROVIDES	provides
PROVISIONAL	provisional
PSSTRINGTOKEN	ps-string-token
PUTFIELD	put-field
PUTSTATIC	put-static
PYEXCEPTION	py-exception
PYNEWWRAPPER	py-new-wrapper
QRYATTSCR	qry-att-scr
QRYATTSET	qry-att-set
QRYATTSNS	qry-atts-ns
QRYBLKCTL	qry-blk-ctl
QRYBLKRST	qry-blk-rst
QRYCLSIMP	qry-cls-imp
QRYCLSRLS	qry-cls-rls
QRYINSID	qry-ins-id
QRYNOPRM	qry-no-prm
QRYPOPRM	qry-pop-rm
QRYPRCTYP	qry-prc-typ
QRYRELSCR	qry-rel-scr
QUALIFIERS	qualifiers
RABRACKET	ra-bracket
RAWTYPES	raw-types
RDBACCRM	rdb-acc-rm
RDBCOLID	rdb-col-id
RDBINTTKN	rdb-int-tkn
READDING	readding
READRESOLVE	read-resolve
READWRITE	read-write
RECEIVED	received
RECIPIENT	recipient
RECIPIENTTOKEN	recipient-token
RECOGNIZER	recognizer
RECONCILE	reconcile
RECORDMETHODCALLSPROPNAME	record-method-calls-prop-name
RECOVERY	recovery
RECTHEIGHT	rect-height
REDCOMPONENT	red-component
REDEFINE	redefine
REDIRECT	redirect
REFERENCE	reference
REFERENCEPARAMETERS	reference-parameters
REFERRAL	referral
REFRESHER	refresher
REFRESHFIELDSCOPE	refresh-field-scope
REGISTRATIONS	registrations
REJECTION	rejection
RELEASED	released
RELEASES	releases
REMAINDER	remainder
REMINDERCHECKMINS	reminder-check-mins
RENDERER	renderer
REPORTLOCATION	report-location
REPORTPLUGINS	report-plugins
REPOSITORY	repository
REQUESTATTRIBUTESIN	request-attributes-in
REQUESTATTRIBUTESOUT	request-attributes-out
REQUESTPROTECTIONAUTHRECIPIENT	request-protection-auth-recipient
REQUESTPROTECTIONAUTHSOURCE	request-protection-auth-source
REQUESTSECURITYTOKENTEMPLATE	request-security-token-template
REQUIRECANCELSCT	require-cancel-sct
REQUIREDELEMENTS	required-elements
REQUIREEMBEDDEDTOKENREFERENCE	require-embedded-token-reference
REQUIREEXTERNALURIREFERENCE	require-external-uri-reference
REQUIREKEYIDENTIFIERREFERENCE	require-key-identifier-reference
REQUIRETHUMBPRINTREFERENCE	require-thumb-print-reference
RESOURCEADAPTERNAME	resource-adapter-name
RESOURCEFOLDERS	resource-folders
RESTOREDIR	restore-dir
RESTRICTION	restriction
REVOCATION	revocation
RGNDATAHEADER	rgn-data-header
RGREATER	r-greater
RIGHTDISABLED	right-disabled
RIGHTOUTERJOIN	right-outer-join
RMFLOWCONTROL	rm-flow-control
ROLLEDUP	rolled-up
ROOTNODE	root-node
RSCLMTRM	rsc-lmt-rm
RSLSETRM	rsl-set-rm
RSQBRACKET	rsq-bracket
SATURDAY	saturday
SAXFACTORYDESCRIPTION	sax-factory-description
SCALAGOALS	scala-goals
SCALAREXCEPTION	scalar-exception
SCARIEST	scariest
SCCONFIGURATION	sc-configuration
SCHEDULE	schedule
SCHEDULING	scheduling
SCHEMATYPE	schema-type
SCHEMAVALIDATE	schema-validate
SCOPENODE	scope-node
SCRIPTSOURCEDIRECTORY	script-source-directory
SEASHELL	seashell
SECCHKCD	sec-chk-cd
SECCHKRM	sec-chk-rm
SECURECONVERSATION	secure-conversation
SECURECONVERSATIONTOKEN	secure-conversation-token
SELECTABLE	selectable
SELECTED	selected
SELECTOR	selector
SELFCERT	self-cert
SEPERATOR	seperator
SEQUENTIAL	sequential
SERIALNUMBER	serial-number
SERVICEENDPOINTINTERFACE	service-endpoint-interface
SERVICEPRINCIPAL	service-principal
SERVICESELECTOR	service-selector
SERVLETDATA	servlet-data
SETINCURRENTINSTANCE	set-in-current-instance
SETITEMS	set-items
SETPARENT	set-parent
SEVERITIES	severities
SEVERITY	severity
SHARABLE	sharable
SHELLNAME	shell-name
SHORTVAL	short-val
SHOWOUTPUT	show-output
SHOWOWNSEEK	show-own-seek
SHOWUSHOLIDAYS	show-us-holidays
SHRINKABLE	shrinkable
SIGNATURE	signature
SIGNEDENCRYPTEDSUPPORTINGTOKENS	signed-encrypted-supporting-tokens
SIGVTALRM	sig-vtal-rm
SIGWAITING	sig-waiting
SIGWINCH	sig-winch
SINGLETON	singleton
SIZINGMARGINS	sizing-margins
SKELETON	skeleton
SNAPSHOT	snapshot
SOFTLINK	soft-link
SOMEBITS	some-bits
SORTEDPRESSED	sorted-pressed
SORTEDUP	sorted-up
SORTERTABLELENGTH	sorter-table-length
SOURCEDIRECTORY	source-directory
SOURCEPATH	source-path
SPECIFICATIONS	specifications
SPINNERFONT	spinner-font
SPLATNODE	splat-node
SPLITCDATA	split-cdata
SPLITINDEX	split-index
SPLITTER	splitter
SPNEGOCONTEXT	sp-neg-o-context
SQLCSRHLD	sql-csr-hld
SQLDTARD	sql-dta-rd
SQLPRIMARYKEYS	sql-primary-keys
SQLPROCEDURECOLS	sql-procedure-cols
SQLSPECIALCOLUMNS	sql-special-columns
SQLSTTVRB	sql-stt-vrb
SQLTABLES	sql-tables
SQLWARNING	sql-warning
SRVRLSLV	srvrlslv
STACKTRACE	stack-trace
STANDARD	standard
STANDARDSTATUS	standard-status
STARTEDEARLY	started-early
STARTELT	start-elt
STARTGRP	start-grp
STARTING	starting
STARTMENU	start-menu
STARTPOS	start-pos
STARTTAG	start-tag
STATELESS	state-less
STATICINITIALIZATION	static-initialization
STAXPRODUCEXMLEVENTREADER	stax-produce-xml-event-reader
STAXUSEXMLEVENTREADER	stax-use-xml-event-reader
STEADYPOOLSIZE	steady-pool-size
STOPCHARS	stop-chars
STOPPERS	stoppers
STOPPING	stopping
STOREPASSWD	store-passwd
STRENGTH	strength
STRICTFP	strict-fp
STRICTPOOLING	strict-pooling
STRINGLITERAL	string-literal
STUDENTS	students
STYLESHEETSTATUS	style-sheet-status
SUBITEMCOMPLETED	sub-item-completed
SUBITEMSKIPPED	sub-item-skipped
SUBJECTS	subjects
SUBPACKAGE	sub-package
SUBSELECT	sub-select
SUBSYSTEM	subsystem
SUBVERSION	subversion
SUGGESTIONS	suggestions
SUPERNODE	super-node
SUPERSEDED	superseded
SUPERTYPE	super-type
SUPPORTINGTOKENS	supporting-tokens
SUPPORTS	supports
SUPPRESSING	suppressing
SUSPENDED	suspended
SWAPPABLE	swappable
SWITCHRATIO	switch-ratio
SYMMETRICBINDING	symmetric-binding
SYNCMINS	sync-mins
SYNCNODES	sync-nodes
SYNCSUMMARY	sync-summary
SYNTAXRM	syntax-rm
TABLENAME	table-name
TAGBANWA	tag-banwa
TARGETEXTRA	target-extra
TASMANIA	tasmania
TEMPLATE	template
TEMPLATES	templates
TEMPORARY	temporary
TERMINALFONTPROPNAME	terminal-font-prop-name
TERMVECTOR	term-vector
TERTIARY	tertiary
TESTRESOURCE	test-resource
TESTRESOURCES	test-resources
TESTSUITES	test-suites
TEXTAREA	text-area
TEXTCOLOR	text-color
TEXTFILE	text-file
THOMBSTONE	thomb-stone
THREADGROUP	thread-group
THRESHOLD	threshold
THROWABLE	throwable
TIMEOUTNAME	timeout-name
TIMEZONE	time-zone
TLONGINT	t-long-int
TMRESUME	tm-resume
TNUMERICLARGE	t-numeric-large
TOARYNODE	to-ary-node
TODOVIEWSIZE	to-do-view-size
TOPDOWNLEFTRIGHT	top-down-left-right
TOPSCOPE	top-scope
TOPTHINROUNDED	top-thin-rounded
TRACECOUNTS	trace-counts
TRACKING	tracking
TRAMPOLINE	trampoline
TRANSACTIONISOLATIONLEVEL	transaction-isolation-level
TRANSACTIONTYPE	transaction-type
TRANSFERABLE	transferable
TRANSFERENCODING	transfer-encoding
TRANSFERING	transfering
TRANSFORM	transform
TRANSLATIONS	translations
TRANSLUCENT	translucent
TRANSMIT	transmit
TRANSPORTTOKEN	transport-token
TRAVERSAL	traversal
TRESHOLD	treshold
TRGDFTRT	trgdftrt
TRUENODE	true-node
TRUNCAPPT	trunc-appt
TRUNCATED	truncated
TRUSTANCHOR	trust-anchor
TSMALLINT	t-small-int
TVARCHAR	t-var-char
TWENTYFOURBITGROUP	twenty-four-bit-group
TXRECOVERY	tx-recovery
TYPEARRAY	type-array
TYPEBOUNDKIND	type-bound-kind
TYPEBUILDER	type-builder
TYPECODE	type-code
TYPEIDENT	type-ident
TYPEMODIFIER	type-modifier
TYPEOFNAME	type-of-name
TYPEPARAM	type-param
TYPEPARAMETERS	type-parameters
TYPSQLDA	typ-sql-da
UNAMELEN	u-name-len
UNATTRIBUTED	unattributed
UNBOUNDED	unbounded
UNCAUGHT	uncaught
UNCERTAIN	uncertain
UNCHANGED	unchanged
UNCHECKED	unchecked
UNCHECKEDID	unchecked-id
UNDECLARED	undeclared
UNDEFINE	undefine
UNEDITABLE	uneditable
UNEXCLUDE	unexclude
UNICODECOUNT	unicode-count
UNICODERANGE	unicode-range
UNINSTANTIATE	uninstantiate
UNIONJOIN	union-join
UNIQUEDESC	unique-desc
UNKOWNTYPE	unkown-type
UNLABELED	unlabeled
UNLOADED	unloaded
UNLOCKED	unlocked
UNMAPPED	unmapped
UNORDERED	unordered
UNPREDICTABLE	unpredictable
UNQUALIFIED	unqualified
UNREACHABLE	unreachable
UNREPEATABLE	unrepeatable
UNSIGNEDBYTE	unsigned-byte
UNTOUCHED	untouched
UNVALIDATED	unvalidated
UNZIPPED	unzipped
UPDATEPOLICY	update-policy
UPPERCASE	uppercase
UPPOINTER	up-pointer
UPPRESSED	up-pressed
URLREPLACEMENT	url-replacement
USECUSTOMEDITORKIT	use-custom-editor-kit
USEFEATURES	use-features
USERDESC	user-desc
VALIDATING	validating
VALIDATION	validation
VARBINARY	var-binary
VERIFIED	verified
VERIFIER	verifier
VERSCROLLBAR	ver-scroll-bar
VICTORIA	victoria
VISIBILITYCHARS	visibility-chars
VMOPTIONS	vm-options
VOIDTYPE	void-type
WEBSERVICES	web-services
WEBSPHERE	web-sphere
WINDOWINFO	window-info
WINDOWTITLEFONT	window-title-font
WITHINCODE	within-code
WITHSOURCECODEONLY	with-source-code-only
WKSTARTHOUR	wk-start-hour
WORDLIST	word-list
WORKGROUP	work-group
WORKSPACE	work-space
WORKTIME	work-time
WORKUNITS	work-units
WRITEBEANGRAPHFILE	write-bean-graph-file
WRITEOBJECT	write-object
WRITERMAP	writer-map
WSCOMPILE	ws-compile
WSDLLOCATION	wsdl-location
WSDLPORTID	wsdl-port-id
WSENDPOINT	ws-end-point
XMAXWARNS	x-max-warns
XMLSCHEMA	xml-schema
XMLVERSION	xml-version
XSTRNODE	xstr-node
YEARMONTHDURATION	year-month-duration
YIELDNODE	yield-node
YUILOADER	y-ui-loader
YYERRCODE	yy-err-code
YYTABLESIZE	yy-table-size
abbreviated	abbreviated
abbreviator	abbreviator
aborting	aborting
absolute	absolute
absorbweight	absorb-weight
abstraction	abstraction
acceptfilter	accept-filter
accepting	accepting
acceptors	acceptors
accessable	accessable
accessibility	accessibility
accessible	accessible
accessmanager	access-manager
accumulate	accumulate
accumulator	accumulator
acknowledge	acknowledge
acquired	acquired
acquires	acquires
actionevent	action-event
activeclientremove	active-client-remove
activematch	active-match
activerecord	active-record
actualizer	actualizer
actualpages	actual-pages
addbutton	add-button
additionalparam	additional-param
addproperty	add-property
addsection	add-section
adjacency	adjacency
adjacent	adjacent
adjective	adjective
adjustfill	adjust-fill
adjustment	adjustment
affinity	affinity
afirstline	a-first-line
agentmain	agent-main
agreement	agreement
agressive	agressive
aliasing	aliasing
alignment	alignment
alignments	alignments
allappts	all-appts
allchildren	all-children
allfiles	all-files
allgrammars	all-grammars
allinterfaces	all-interfaces
allmodes	all-modes
allnotifiers	all-notifiers
allocate	allocate
allocated	allocated
allocation	allocation
allocations	allocations
allocator	allocator
allowuserinteraction	allow-user-interaction
alltimes	all-times
allwhites	all-whites
alocalpart	a-local-part
alpright	alp-right
alreadycontain	already-contain
alternate	alternate
alternatives	alternatives
amcestor	amcestor
anactivator	an-activator
analyser	analyser
analyses	analyses
analysis	analysis
ancestors	ancestors
anchleads	anch-leads
anewarray	a-new-array
annotate	annotate
annotation	annotation
announce	announce
antecedent	antecedent
anticount	anti-count
antipatterns	anti-patterns
antiquewhite	antique-white
anymodify	any-modify
anything	anything
apcompare	ap-compare
appearance	appearance
appletbg	applet-bg
appletclass	applet-class
applicationstartupfactory	application-startup-factory
applymethod	apply-method
applymethods	apply-methods
appointment	appointment
approximate	approximate
appsrcloc	app-src-loc
aptclasspath	apt-class-path
archetypes	archetypes
archivepatterns	archive-patterns
arcwidth	arc-width
areflective	a-reflective
arelative	a-relative
argaction	arg-action
argbmodel	arg-b-model
arglleft	arg-l-left
argoffset	arg-offset
argslist	args-list
arguments	arguments
arlpright	arlp-right
arrayify	arrayify
arrayobj	array-obj
arrayref	array-ref
arraysep	array-sep
arrowhead	arrow-head
asciidump	ascii-dump
aselection	a-selection
asobject	as-object
assemblies	assemblies
assembling	assembling
assignement	assignement
assignors	assignors
assistants	assistants
assurance	assurance
asterisks	asterisks
astoffset	ast-offset
attachable	attachable
attachement	attachement
attachements	attachements
attachemnts	attachemnts
attrcapacity	attr-capacity
attributebinding	attribute-binding
attributekey	attribute-key
attrigutes	attrigutes
attrlist	attr-list
attvalue	att-value
augument	augument
ausecase	a-use-case
authenticators	authenticators
authfile	auth-file
autoactivation	auto-activation
autoboxed	auto-boxed
autobuild	auto-build
autoclosing	auto-closing
autocomplete	auto-complete
autoconnect	auto-connect
autocorrect	auto-correct
autoenable	auto-enable
autolink	auto-link
autolinking	auto-linking
automation	automation
autorelease	auto-release
autosave	auto-save
autoscroll	auto-scroll
autoshow	auto-show
autosize	auto-size
autospec	auto-spec
autowidth	auto-width
auxfiles	aux-files
auxiliaries	auxiliaries
auxinput	aux-input
auxlength	aux-length
auxobject	aux-object
availability	availability
availabilties	availabilties
availbits	avail-bits
availinfo	avail-info
averages	averages
awareness	awareness
awtfontpaths	awt-font-paths
axiparent	axi-parent
axisright	axis-right
backbuffer	back-buffer
background	background
backround	back-round
backspace	back-space
backupcopy	backup-copy
backward	backward
bandwidth	bandwidth
barycenters	bary-centers
baseclasses	base-classes
basedirs	base-dirs
basefile	base-file
basefiles	base-files
basefont	base-font
basekeys	base-keys
baselinedir	baseline-dir
baselines	baselines
basepred	base-pred
basetype	base-type
batchsize	batch-size
bcolstart	b-col-start
bcontext	b-context
bdividend	b-dividend
bdivisor	b-divisor
bdversion	bd-version
beanclass	bean-class
beanname	bean-name
beanshell	bean-shell
beautify	beautify
beggining	beggining
beginindex	begin-index
beginpos	begin-pos
behavioralfeatures	behavioral-features
benchmarks	benchmarks
bestmatch	best-match
bestmove	best-move
bfilelist	b-file-list
bfragment	b-fragment
bgstream	bg-stream
bidirectional	bidirectional
binaries	binaries
bindings	bindings
bindpoint	bind-point
birthday	birthday
bitcount	bit-count
bitflags	bit-flags
bitoffset	bit-offset
bitsleft	bits-left
bitstream	bit-stream
blacklist	blacklist
blockinput	block-input
blockscope	block-scope
blocksize	block-size
blueviolet	blue-violet
bndbytes	bnd-bytes
bodycontent	body-content
boffsets	b-offsets
boldfont	bold-font
bookmarkable	bookmarkable
booleans	booleans
boolvalue	bool-value
bootclasspathref	boot-class-path-ref
bootclasspaths	boot-class-paths
bordered	bordered
bottomright	bottom-right
bottomtext	bottom-text
bouncesize	bounce-size
boundary	boundary
boundkind	bound-kind
boundname	bound-name
branchrow	branch-row
breakdown	breakdown
brightness	brightness
bubbling	bubbling
bufcolumn	buf-column
bufferdata	buffer-data
buildlabel	build-label
builtmodules	built-modules
bulletgap	bullet-gap
bundleclasspath	bundle-class-path
bundleentry	bundle-entry
bundlekey	bundle-key
bundletext	bundle-text
buttoncomp	button-comp
buttonpanel	button-panel
buttonsgroup	buttons-group
buttonsshow	buttons-show
bytecount	byte-count
bytedata	byte-data
bytelist	byte-list
bytesize	byte-size
bytestream	byte-stream
byteswritten	bytes-written
bytevalue	byte-value
cachable	cachable
cacheability	cacheability
cachedirstr	cache-dir-str
calculable	calculable
calendar	calendar
calender	calender
calibrate	calibrate
callback	callback
calldata	call-data
canceled	canceled
canondir	canon-dir
canonise	canonise
canonpath	canon-path
capabilities	capabilities
capitalise	capitalise
capitalize	capitalize
cardinality	cardinality
castexpr	cast-expr
catagory	catagory
catalogfo	catalog-fo
catalogms	catalog-ms
catchtype	catch-type
categories	categories
categorize	categorize
cbxlistener	cbx-listener
cconvert	c-convert
cellvars	cell-vars
cellwidth	cell-width
cendatalen	cen-data-len
certcoll	cert-coll
certfile	cert-file
certificate	certificate
certificates	certificates
certserno	certs-erno
cfeature	c-feature
cfilelist	c-file-list
changeable	changeable
changedir	change-dir
changenumber	change-number
characteristic	characteristic
charattrs	char-attrs
charcapacity	char-capacity
charfilename	char-file-name
charsets	char-sets
charsize	char-size
chartype	char-type
checkable	checkable
checkboxen	check-boxen
checkboxes	check-boxes
checkboxlist	check-box-list
checkcount	check-count
checkcycles	check-cycles
checkexpired	check-expired
checkfield	check-field
checkfpx	check-fpx
checkout	checkout
checkpoint	check-point
checksum	checksum
checkundo	check-undo
childcount	child-count
childern	child-ern
childfin	child-fin
childtype	child-type
chronology	chronology
ciespace	cie-space
circunvent	circunvent
clarifier	clarifier
classbytes	class-bytes
classfields	class-fields
classfiles	class-files
classifiables	classifiables
classinfo	class-info
classlink	class-link
classlist	class-list
classmethods	class-methods
classname	class-name
classnameleft	class-name-left
classpaths	class-paths
clazzfile	clazz-file
cleanname	clean-name
cleanreportlocation	clean-report-location
cleansed	cleansed
cleanups	cleanups
cleanupzip	cleanup-zip
clicknclick	click-n-click
clientremove	client-remove
clippath	clip-path
clipping	clipping
clistener	c-listener
closeleft	close-left
closeright	close-right
closures	closures
clsattrs	cls-attrs
cltypelower	cl-type-lower
cmdclass	cmd-class
cmdextdir	cmd-ext-dir
cmethods	c-methods
cmndarray	cmnd-array
cnfexcept	cnf-except
cntchanges	cnt-changes
codeattrs	code-attrs
codebases	code-bases
codename	code-name
codesets	code-sets
codesource	code-source
colincxerr	col-inc-xerr
collapsed	collapsed
collapser	collapser
collapsible	collapsible
collapsing	collapsing
collected	collected
collector	collector
collision	collision
colnames	col-names
colonpos	colon-pos
colonptr	colon-ptr
coloring	coloring
colorize	colorize
colorkey	color-key
colormap	color-map
colormodel	color-model
colornum	color-num
colorsel	color-sel
colorstr	color-str
colorval	color-val
columndata	column-data
columnidx	column-idx
columnnames	column-names
colvaluedt	col-value-dt
colwidth	col-width
comettimeout	comet-timeout
comlumns	comlumns
commandline	command-line
commonkeys	common-keys
communities	communities
community	community
compactify	compactify
comparable	comparable
comparerule	compare-rule
comparison	comparison
comparissons	comparissons
compatible	compatible
compilable	compilable
compilation	compilation
compilers	compilers
compilertype	compiler-type
compiling	compiling
compindex	comp-index
complement	complement
completionlayout	completion-layout
completor	completor
complexity	complexity
componentsorter	component-sorter
composed	composed
composer	composer
composers	composers
composite	composite
composition	composition
compositions	compositions
compound	compound
comprehension	comprehension
compress	compress
compression	compression
compthing	comp-thing
comptype	comp-type
compversion	comp-version
comtarget	com-target
concatenate	concatenate
concatenating	concatenating
concepts	concepts
concretizing	concretizing
concurent	concurent
concurrent	concurrent
conditions	conditions
condright	cond-right
condtype	cond-type
configmap	config-map
configname	config-name
configobj	config-obj
configurations	configurations
configurator	configurator
configured	configured
configurer	configurer
conflict	conflict
conflictees	conflictees
conflicting	conflicting
confusable	confusable
conglomerates	conglomerates
conglomid	conglom-id
conjunction	conjunction
conndefname	conn-def-name
conndefnname	conn-def-nname
connpoolresource	conn-pool-resource
conservative	conservative
considerapi	consider-api
considered	considered
considerinternal	consider-internal
consideruse	consider-use
consistency	consistency
containerdescriptions	container-descriptions
containerid	container-id
containers	containers
containing	containing
contants	contants
contentinfo	content-info
contentions	contentions
contextpath	context-path
contexts	contexts
continent	continent
continued	continued
continuous	continuous
contract	contract
contrast	contrast
contribs	contribs
contribute	contribute
contributions	contributions
controller	controller
converged	converged
conversions	conversions
convertdst	convert-dst
convertible	convertible
convertors	convertors
convertres	convert-res
convertsrc	convert-src
copyability	copyability
copyable	copyable
copyfrom	copy-from
copyregs	copy-regs
copyrighttext	copyright-text
corecontext	core-context
coreitemws	core-item-ws
corrected	corrected
countries	countries
covering	covering
cpelements	cp-elements
cpentries	cp-entries
cphelper	cp-helper
cpopcode	cp-opcode
cptester	cp-tester
createaction	create-action
createstr	create-str
creators	creators
cresources	c-resources
criterions	criterions
crosscounts	cross-counts
crossings	crossings
crossref	cross-ref
crttoken	crt-token
csources	c-sources
ctparams	ct-params
ctxflags	ctx-flags
ctxpanel	ctx-panel
ctxtattr	ctxt-attr
ctypestr	c-type-str
currentbuffer	current-buffer
currentelement	current-element
currentlast	current-last
currently	currently
currentpc	current-pc
currentreferee	current-referee
currenttime	current-time
currtime	curr-time
curscore	cur-score
curstrokes	cur-strokes
curvelist	curve-list
curvetag	curve-tag
customer	customer
customizable	customizable
customizations	customizations
customize	customize
customrpt	custom-rpt
cxtimeout	cx-timeout
cybergreen	cyber-green
cyclenow	cycle-now
daemonize	daemonize
darkblue	dark-blue
darkgoldenrod	dark-goldenrod
darkgreen	dark-green
darkolivegreen	dark-olive-green
dataarray	dataarray
database	database
databases	databases
datafile	data-file
dataflow	data-flow
dataoutputstream	data-output-stream
datapair	data-pair
datapath	data-path
datapusher	data-pusher
dataraces	data-races
datasource	data-source
datatable	data-table
datatype	data-type
dateformat	date-format
datesyms	date-syms
datetext	date-text
datetime	date-time
dayofweek	day-of-week
dbcleanup	db-cleanup
dbfactory	db-factory
dbownerfield	db-owner-field
dbuilder	d-builder
ddifference	d-difference
deadlocks	deadlocks
debuggers	debuggers
debugging	debugging
debugmode	debug-mode
debugstackmap	debug-stack-map
debugstr	debug-str
declarations	declarations
declarators	declarators
declared	declared
declarer	declarer
declares	declares
declination	declination
declmimes	decl-mimes
decodabet	decod-abet
decompressor	decompressor
decoration	decoration
decrement	decrement
defauilt	defauilt
defaultallowuserinteraction	default-allow-user-interaction
defaultbg	default-bg
defaultdict	default-dict
defaulted	defaulted
defaulter	defaulter
defaultexcludes	default-excludes
defaultfolder	default-folder
defaultoffset	default-offset
defaults	defaults
defaultsl	default-sl
defaultt	default-t
defcolor	def-color
deferring	deferring
defgetter	def-getter
defintions	defintions
defnames	def-names
defvalfield	def-val-field
delegate	delegate
delegated	delegated
delegatee	delegatee
delegateid	delegate-id
delegates	delegates
delegating	delegating
delegator	delegator
deletables	deletables
deletedrendering	deleted-rendering
deligator	deligator
delimend	delimend
delivery	delivery
delprefix	del-prefix
demangled	demangled
demangler	demangler
denyfromall	deny-from-all
departement	departement
departments	departments
dependancy	dependancy
dependants	dependants
dependees	dependees
dependenciees	dependenciees
dependent	dependent
depending	depending
depenencies	depenencies
deployable	deployable
deployers	deployers
deployments	deployments
depprojects	dep-projects
deprecated	deprecated
deprecation	deprecation
dereference	dereference
dereferenced	dereferenced
dereferencer	dereferencer
deregister	deregister
derivational	derivational
derivers	derivers
desciptors	desciptors
describe	describe
descripti	descripti
descritor	descritor
descrptr	descrptr
deserial	deserial
designator	designator
destfiles	dest-files
destfolder	dest-folder
destinations	destinations
destoyed	destoyed
destructure	destructure
detokenated	detokenated
deviation	deviation
devnames	dev-names
devoidify	devoidify
dfactory	d-factory
diagnostics	diagnostics
didsomething	did-something
differencer	differencer
differences	differences
diffname	diff-name
diffprovider	diff-provider
diffvalue	diff-value
digestalgos	digest-algos
digested	digested
digester	digester
directives	directives
director	director
dirfolder	dir-folder
dirtyprops	dirty-props
dirtyres	dirty-res
disabled	disabled
disabler	disabler
disallowed	disallowed
disambiguate	disambiguate
disassembled	disassembled
disassembler	disassembler
discarding	discarding
disclaimer	disclaimer
disconnected	disconnected
disconnector	disconnector
discontiguous	discontiguous
discovers	discovers
discovery	discovery
discrepancy	discrepancy
disjoint	disjoint
disjunction	disjunction
dismantle	dismantle
dispatch	dispatch
dispatchable	dispatchable
dispatched	dispatched
dispatcher	dispatcher
dispatches	dispatches
dispatching	dispatching
disposable	disposable
dissolve	dissolve
distinct	distinct
distinction	distinction
distribute	distribute
diversified	diversified
diversify	diversify
dividend	dividend
dividers	dividers
divindex	div-index
divisions	divisions
dncprint	dnc-print
doaction	do-action
dockables	dockables
docommand	docommand
documented	documented
documents	documents
dodgerblue	dodger-blue
dollared	dollared
dominant	dominant
dominators	dominators
donotfire	do-not-fire
dotclasspos	dot-class-pos
dotnames	dot-names
doublesrcarr	double-src-arr
doublevalue	double-value
doupdate	do-update
downcase	down-case
downcast	down-cast
downloaddir	download-dir
downloaders	downloaders
downloading	downloading
downsize	down-size
dparameters	d-parameters
dragable	dragable
dragarea	dragarea
draggables	draggables
draining	draining
drawable	drawable
drilldown	drill-down
drivername	driver-name
driversdeployed	drivers-deployed
dropwhile	drop-while
dshelper	ds-helper
dsources	d-sources
dtactions	dt-actions
duckable	duckable
dumprels	dump-rels
duplicate	duplicate
duplicity	duplicity
dwindows	d-windows
eclipsecompiler	eclipse-compiler
ecounter	e-counter
edgelist	edge-list
editedrc	edited-rc
editfilters	edit-filters
editions	editions
editsize	edit-size
edittypes	edit-types
eepromfile	eeprom-file
effected	effected
ehandler	e-handler
ejbproject	ejb-project
emacssym	emacs-sym
emailtext	email-text
emailtimebox	email-time-box
embeddable	embeddable
embedded	embedded
embedder	embedder
embeddings	embeddings
emptiable	emptiable
emulator	emulator
enablebaselessmerges	enable-baseless-merges
enablements	enablements
encapsulator	encapsulator
enclosed	enclosed
encloser	encloser
encloses	encloses
enclosure	enclosure
encltype	encl-type
encoders	encoders
encoding	encoding
encodingc	encodingc
encodings	encodings
encrypted	encrypted
encrypter	encrypter
encrypting	encrypting
encryption	encryption
encryptpassword	encrypt-password
endindex	end-index
endminute	end-minute
endofline	end-of-line
endorsed	endorsed
endquote	end-quote
enshortdays	en-short-days
entensions	entensions
entityarray	entity-array
entryindex	entry-index
entryinterface	entry-interface
entrylists	entry-lists
entryname	entry-name
entrynames	entry-names
entryoids	entryoids
entrypath	entry-path
enumerable	enumerable
enumeratorize	enumeratorize
envblock	env-block
envclasspath	env-class-path
envelope	envelope
envprops	env-props
equality	equality
ergonomics	ergonomics
errlevel	err-level
errmajor	err-major
errordesc	error-desc
errormsg	error-msg
errorseen	error-seen
errorstream	error-stream
escliteral	esc-literal
established	established
estimated	estimated
estimates	estimates
estimator	estimator
evaluate	evaluate
evaluations	evaluations
eventtype	event-type
everytime	every-time
ewvright	ewv-right
exactness	exactness
excepthandlers	except-handlers
exchange	exchange
exchanges	exchanges
excludedocfilessubdir	exclude-doc-files-sub-dir
exclusionlist	exclusion-list
exclusions	exclusions
excomposite	ex-composite
excontrol	ex-control
excontrols	ex-controls
execpath	exec-path
executemany	execute-many
executing	executing
execution	execution
executionresult	execution-result
executors	executors
exemplar	exemplar
exitcode	exit-code
expenses	expenses
expiration	expiration
exploded	exploded
exportbutton	export-button
exported	exported
exporter	exporter
exposures	exposures
expression	expression
exprleft	expr-left
extended	extended
extender	extender
extensionsids	extensions-ids
externals	externals
externalzied	externalzied
extracted	extracted
extracter	extracter
extracting	extracting
extraction	extraction
extractor	extractor
extraflags	extra-flags
factoryinstance	factory-instance
failedmodules	failed-modules
failover	fail-over
fairness	fairness
fakeproj	fake-proj
fallback	fall-back
families	families
fastlocals	fast-locals
fasttrack	fast-track
fattribute	f-attribute
favorite	favorite
fdatasync	f-data-sync
feedback	feedback
fentries	f-entries
fetchloop	fetch-loop
fgelements	fg-elements
fgfactor	fg-factor
fictional	fictional
fieldlist	field-list
fieldname	field-name
fieldsize	field-size
figclassname	fig-class-name
filechooser	file-chooser
filemenu	file-menu
filenamelength	file-name-length
filenode	file-node
filerimpl	filer-impl
filesets	file-sets
filesize	file-size
filesystem	file-system
filetoken	file-token
filetotest	file-to-test
filllabel	fill-label
fillpipe	fill-pipe
filterchain	filter-chain
filtername	filter-name
filternode	filter-node
filtertrace	filter-trace
finaladdress	final-address
finalbody	final-body
finalizers	finalizers
finallyblock	finally-block
findleaks	find-leaks
findpage	find-page
finished	finished
firebrick	fire-brick
firstbound	first-bound
firstchild	first-child
firstmask	first-mask
firsttime	first-time
firstuscore	first-uscore
fixednames	fixed-names
fixindex	fix-index
flatmatrix	flat-matrix
floatable	floatable
floatxorarr	float-xor-arr
floralwhite	floral-white
flowgraph	flow-graph
flyweight	flyweight
fmapings	f-mapings
follower	follower
followers	followers
following	following
fontsize	font-size
fontstyle	font-style
forecolor	fore-color
foregrounds	foregrounds
formathash	for-math-ash
formatlabel	format-label
formatmenu	format-menu
formatted	formatted
formatter	formatter
formfile	form-file
formulas	formulas
forwarder	forwarder
forwarding	forwarding
foundencoding	found-encoding
fplugins	f-plugins
fragement	fragement
fragpieces	frag-pieces
framecount	frame-count
framework	framework
frequencies	frequencies
frgbvalue	f-rgb-value
fromlist	from-list
fromright	from-right
fsection	f-section
fshortcut	f-shortcut
ftruncate	f-truncate
fubounds	f-ubounds
fulfilled	fulfilled
fullcopy	full-copy
fullexpression	full-expression
fullmode	full-mode
fullrepaint	full-repaint
functioning	functioning
funneler	funneler
furthesty	furthest-y
futurelns	future-lns
gainsboro	gainsboro
ganttbutton	gantt-button
garbages	garbages
gatherer	gatherer
gccsmeth	gccs-meth
gdkvisual	gdk-visual
generalizations	generalizations
generateclient	generate-client
generated	generated
generater	generater
generator	generator
generators	generators
genericop	generic-op
generictype	generic-type
genfiles	gen-files
gengetpropbyname	gen-get-prop-by-name
genldata	genl-data
genswitch	gen-switch
gensymindex	gen-sym-index
geometry	geometry
getaddress	get-address
getarray	get-array
getattribute	get-attribute
getclosure	get-closure
getcodesize	get-code-size
getfilesystemencoding	get-file-system-encoding
getgrnam	get-gr-nam
gethostbyaddr	get-host-by-addr
getlabel	get-label
getlocal	get-local
getmaster	get-master
getmodule	get-module
getnameinfo	get-name-info
getorset	get-or-set
getparent	get-parent
getpwnam	get-pwnam
getpwuid	get-pwuid
getresource	get-resource
getresources	get-resources
getrlimitnofiles	get-r-limit-no-files
getscore	get-score
getservers	get-servers
getservlet	get-servlet
getservlets	get-servlets
getsockname	get-sock-name
getstate	get-state
getstatic	get-static
getstats	get-stats
gettable	get-table
ghostwhite	ghost-white
gigabytes	gigabytes
gjobject	gj-object
glyphcode	glyph-code
goalcompleter	goal-completer
grabbing	grabbing
gradients	gradients
grandcestor	grandcestor
grandparent	grandparent
grantable	grantable
granularities	granularities
grestore	gre-store
gridheight	grid-height
groovygroup	groovy-group
groupdict	group-dict
groupmask	group-mask
gsection	g-section
guaranteed	guaranteed
guessing	guessing
haltleft	halt-left
haltright	halt-right
handbacks	hand-backs
handlecache	handle-cache
handleize	handleize
handlerclass	handler-class
handlername	handler-name
handlerpc	handle-rpc
handshake	hand-shake
harmless	harmless
hasalpha	has-alpha
haschild	has-child
hasfocus	has-focus
hasharray	hash-array
hashbytes	hash-bytes
hashlength	hash-length
hashslot	hash-slot
hbthread	hbth-read
headername	header-name
headonly	head-only
helpstylefile	help-style-file
helpstylefilename	help-style-file-name
helptext	help-text
hexadecimal	hexadecimal
hexdigest	hex-digest
hgconfig	hg-config
hibounds	hi-bounds
hierarchy	hierarchy
highlights	highlights
highlihgtings	highlihgtings
highrate	high-rate
hiragana	hiragana
historyfile	history-file
hiyindex	hiy-index
hlocation	h-location
hlpercent	hl-percent
holdbuffer	hold-buffer
homedrive	home-drive
homepage	home-page
homepath	home-path
homogenize	homogenize
honeydew	honeydew
hostandport	host-and-port
hostdata	host-data
hostloader	host-loader
hostname	host-name
hostport	host-port
hotspotcode	hotspot-code
hotspots	hotspots
hpadding	h-padding
hrequest	h-request
hresponse	h-response
htmlfile	html-file
htmlname	html-name
htmlrenderer	html-renderer
huffcode	huff-code
hulpbias	hulp-bias
hundredth	hundredth
hundredths	hundredths
hyphenatedword	hyphenated-word
hyphenator	hyphenator
iadapter	i-adapter
iarrayload	i-array-load
ibuffered	i-buffered
iconfile	icon-file
iconifiable	iconifiable
idcheckable	id-checkable
identical	identical
identifiable	identifiable
identified	identified
identifier	identifier
idstring	id-string
iepluginid	ie-plugin-id
ifacmpeq	if-acmp-eq
ifacmpne	if-acmp-ne
iftrueright	if-true-right
ignorable	ignorable
ignoredkeys	ignored-keys
ignoreme	ignore-me
ignorerc	ignore-rc
ignorewhitespace	ignore-white-space
ignoring	ignoring
ihandler	i-handler
imagedesc	image-desc
imagelength	image-length
imaginary	imaginary
imgaccessor	img-accessor
imgcache	img-cache
implemented	implemented
implementeds	implementeds
implementer	implementer
implementers	implementers
implementing	implementing
implementor	implementor
implementors	implementors
implicit	implicit
implvendor	impl-vendor
importance	importance
imported	imported
importedfo	imported-fo
importedms	imported-ms
importer	importer
importlocale	import-locale
importreference	import-reference
inactive	inactive
incarnation	incarnation
incllist	incl-list
includeright	include-right
includeself	include-self
includesfile	includes-file
includeversion	include-version
inclusion	inclusion
inclusions	inclusions
inclusive	inclusive
incompatibilities	incompatibilities
incompatible	incompatible
inconvertible	inconvertible
increment	increment
incremental	incremental
incremented	incremented
incrementer	incrementer
increments	increments
indentator	indentator
indeterminate	indeterminate
indexgroup	index-group
indexoflast	index-of-last
indexurl	index-url
indicies	indicies
individual	individual
inelasticity	inelasticity
inetaddr	inet-addr
inferencer	inferencer
infinite	infinite
infinity	infinity
infoplist	info-p-list
informations	informations
inherits	inherits
inicialize	inicialize
inisection	inisection
initclass	init-class
initializations	initializations
initializing	initializing
initials	initials
initiate	initiate
injecting	injecting
injection	injection
inlinetext	inline-text
inlistener	in-listener
innerbar	inner-bar
innerpgram	inner-pgram
inphrase	in-phrase
inputstream	input-stream
inquotes	in-quotes
inscreasing	inscreasing
inscript	in-script
insertable	insertable
inserted	inserted
inserter	inserter
insertsize	insert-size
insource	in-source
installdir	install-dir
installers	installers
instancename	instance-name
instances	instances
instantiate	instantiate
instantiated	instantiated
instantiator	instantiator
instruments	instruments
intdstarr	int-dst-arr
interaction	interaction
interactive	interactive
intercept	intercept
intercepted	intercepted
intercepter	intercepter
intercepting	intercepting
interceptor	interceptor
interceptors	interceptors
interesting	interesting
interfacesright	interfaces-right
interfaes	interfaes
interfase	interfase
interfaze	interfaze
intermediary	intermediary
intermediate	intermediate
internalclasspathref	internal-class-path-ref
internalise	internalise
internalize	internalize
internalpatterns	internal-patterns
internaltrans	internal-trans
interpolate	interpolate
interpolated	interpolated
interpolator	interpolator
interrupted	interrupted
interrupter	interrupter
interruptible	interruptible
interruptor	interruptor
intervaldiff	interval-diff
intervals	intervals
intfaclink	int-fac-link
intilizer	intilizer
intrface	intr-face
intrinsic	intrinsic
introspecthelper	introspect-helper
intvalue	int-value
invalidable	invalidable
invalidate	invalidate
invalidations	invalidations
invhandle	inv-handle
invkgetter	invk-getter
invksetter	invk-setter
invocation	invocation
invocator	invocator
invokestatic	invoke-static
irregulars	irregulars
isconfigured	is-configured
isinstance	is-instance
isolated	isolated
isolation	isolation
isplaintext	is-plain-text
isstatic	is-static
isunicode	is-unicode
itargets	i-targets
itdfieldsig	itd-field-sig
itemsize	item-size
iteraror	iteraror
iterated	iterated
iteratee	iteratee
iteratinglist	iterating-list
iterator	iterator
iteritems	iter-items
ivalstart	i-val-start
ixcheckbox	ix-check-box
jarfiles	jar-files
jarfscache	jar-fs-cache
javacompiler	java-compiler
javacopts	javac-opts
javadocargs	javadoc-args
javaname	java-name
javancss	java-ncss
javaproject	java-project
javaroots	java-roots
javaversion	java-version
jbossxml	jboss-xml
jcalendar	j-calendar
jcharset	j-charset
jjrounds	jj-rounds
jlocation	j-location
jmsresource	jms-resource
jndiname	jndi-name
jnlppath	jnlp-path
jonasroot	jonas-root
jreversion	jre-version
jrmpport	jrmp-port
jscrollpane	j-scroll-pane
jsgroups	js-groups
jsrtarget	jsr-target
jsscryptotoken	jss-crypto-token
jssprivkey	jss-priv-key
jssprivkeytype	jss-priv-key-type
jsssignature	jss-signature
jumpcode	jump-code
justbody	just-body
justified	justified
justifier	justifier
jythoncpy	jython-cpy
keepalive	keep-alive
keepformat	keep-format
keepgoing	keep-going
keybinding	key-binding
keybytes	key-bytes
keyindex	key-index
keyoffset	key-offset
keypassword	key-password
keyright	key-right
keystoretype	key-store-type
keyvector	key-vector
keywordlist	key-word-list
kindfound	kind-found
klassname	klass-name
knowledge	knowledge
knowninterfaces	known-interfaces
labelparams	label-params
labelright	label-right
landmarks	land-marks
landscape	landscape
langindex	lang-index
languages	languages
lastbyte	last-byte
lastchar	last-char
lastchunk	last-chunk
lastcolon	last-colon
lastleft	last-left
lastmatch	last-match
lastmode	last-mode
lastname	last-name
lastpathelement	last-path-element
lastpoint	last-point
lastresult	last-result
lastrowid	last-row-id
laststamp	last-stamp
lastunit	last-unit
launchgroupid	launch-group-id
layoutleft	layout-left
layoutlist	layout-list
lbackground	l-background
lbracket	l-bracket
lcresult	lc-result
lcsymbol	lc-symbol
ldivisor	l-divisor
leafdelta	leaf-delta
leechers	leechers
leftbracket	left-bracket
leftchar	left-char
leftlength	left-length
leftovers	leftovers
leftreference	left-reference
leftshift	left-shift
lemonchiffon	lemon-chiffon
lencachedef	len-cache-def
lentries	l-entries
lfilename	l-file-name
libentries	lib-entries
libnames	lib-names
libpaths	lib-paths
licenses	licenses
lifecycles	lifecycles
lifetime	lifetime
ligatures	ligatures
lightgoldenrodyellow	light-goldenrod-yellow
lightslategray	light-slate-gray
lightslategrey	light-slate-grey
lightsteelblue	light-steel-blue
limiters	limiters
lineargs	line-args
lineinfo	line-info
linespec	line-spec
lineterminator	line-terminator
linklist	link-list
listener	listener
listeners	listeners
listenerz	listenerz
listening	listening
listenop	listen-op
listenrs	listen-rs
listleft	list-left
listmethod	list-method
lmanager	l-manager
loadbugs	load-bugs
lobounds	lo-bounds
localaddr	local-addr
localfield	local-field
localfile	local-file
localindex	local-index
localization	localization
localnames	local-names
localoids	localoids
localoptions	local-options
localref	local-ref
localrootfolder	local-root-folder
localsig	local-sig
localtype	local-type
locbundle	loc-bundle
lockable	lockable
locksync	lock-sync
logcount	log-count
logentry	log-entry
loggable	loggable
loginternal	log-internal
logrecordseen	log-record-seen
logresult	log-result
longform	long-form
longholder	long-holder
longnames	long-names
longopts	long-opts
longtran	long-tran
lookaheads	lookaheads
lookbits	look-bits
loopback	loop-back
loopstart	loop-start
loptions	l-options
lossless	lossless
lowercase	lowercase
lowertbmanager	lower-tb-manager
lreadsel	l-reads-el
lresults	l-results
lrewrite	l-rewrite
lsequence	l-sequence
lseverity	l-severity
ltypename	l-type-name
luminosity	luminosity
lversion	l-version
mailboxes	mail-boxes
mailgroup	mail-group
mailhost	mail-host
mailtime	mail-time
mainargs	main-args
mainclass	main-class
mainrepo	main-repo
malformed	malformed
managedver	managed-ver
manifestproperty	manifest-property
manifests	manifests
manipulators	manipulators
marginwidth	margin-width
markersforall	markers-for-all
marklimit	mark-limit
marshallers	marshallers
marshalling	marshalling
massfade	mass-fade
masthead	masthead
matchedsize	matched-size
materializable	materializable
mattribute	m-attribute
maxattempts	max-attempts
maxblkext	max-blk-ext
maxchars	max-chars
maxgroups	max-groups
maxheight	max-height
maximize	maximize
maxlabel	max-label
maxlength	max-length
maxlevel	max-level
maxoffset	max-offset
maxposition	max-position
maxprefwidth	max-pref-width
maxscore	max-score
mcastaddr	m-cast-addr
mchanged	m-changed
mcontext	m-context
mediumblue	medium-blue
mediumorchid	medium-orchid
megabytes	megabytes
membercount	member-count
memberdocs	member-docs
membername	member-name
memoized	memoized
memwrite	mem-write
menuitem	menu-item
menushell	menu-shell
mergeable	mergeable
mergefiles	merge-files
mergemodules	merge-modules
messager	messager
messages	messages
metaclass	meta-class
metacomp	meta-comp
metacont	meta-cont
metadatas	metadatas
metakeywords	meta-key-words
metalborder	metal-border
metamodel	metamodel
methoddoc	method-doc
methoddtd	method-dtd
methodleft	method-left
methodobject	method-object
methodscope	method-scope
methodsig	method-sig
methodstring	method-string
methodstructure	method-structure
methodvalue	method-value
mfactories	m-factories
mfactory	m-factory
microseconds	micro-seconds
midnightblue	midnight-blue
migrated	migrated
migration	migration
migrations	migrations
millisecs	millisecs
mimepart	mime-part
mindiameter	min-diameter
minibars	mini-bars
minimise	minimise
minimize	minimize
minlevel	min-level
minvalue	min-value
miscellany	miscellany
misplaced	misplaced
missinginfo	missing-info
mistyrose	misty-rose
mksucceed	mk-succeed
mmanager	m-manager
mmddyyyy	mmddyyyy
mnemonic	mnemonic
mnemonicable	mnemonicable
mnemonics	mnemonics
mneumonic	mneumonic
modelorderedcollections	model-ordered-collections
modelsetter	model-setter
modesets	mode-sets
modification	modification
modifications	modifications
modifiers	modifiers
modifyadapter	modify-adapter
monitorexit	monitor-exit
monospace	mono-space
montitor	montitor
moreinfo	more-info
moreints	more-ints
motifdnd	motif-dnd
motorcycle	motorcycle
mouseevent	mouse-event
mproject	m-project
msupport	m-support
multianewarray	multi-a-new-array
multihost	multi-host
multiplicand	multiplicand
multiplier	multiplier
multiproperty	multi-property
multistatus	multi-status
multiview	multi-view
mutators	mutators
muteable	muteable
mydelete	my-delete
mymessage	my-message
myproject	my-project
mysections	my-sections
mythread	my-thread
nameanddesc	name-and-desc
namedefs	name-defs
nameindex	name-index
namespacepermission	namespace-permission
namespaces	namespaces
nativejars	native-jars
nativepaths	native-paths
navigatable	navigatable
nbextraoptions	nb-extra-options
ncapacity	n-capacity
nchildren	n-children
needclientauth	need-client-auth
needsibm	needs-ibm
needssort	needs-sort
negotiate	negotiate
negotiator	negotiator
neighborhood	neighborhood
neighbours	neighbours
nentries	n-entries
nestedclasses	nested-classes
nestlevel	nest-level
netbeans	netbeans
networks	networks
newbaseline	new-baseline
newbranchrow	new-branch-row
newchildren	new-children
newclass	new-class
newclasses	new-classes
newclassname	new-class-name
newclazz	new-clazz
newclone	new-clone
newdigits	new-digits
newelement	new-element
newexclusions	new-exclusions
newholder	new-holder
newkeywords	new-keywords
newmaxsize	new-max-size
newmessage	new-message
newmodel	new-model
newnotelist	new-note-list
newparams	new-params
newparents	new-parents
newpixels	new-pixels
newpname	new-p-name
newpolicy	new-policy
newprops	new-props
newranges	new-ranges
newshiftout	new-shift-out
newstack	new-stack
newstate	new-state
newstats	new-stats
newtasklist	new-task-list
newtexture	new-texture
newvalue	new-value
newvalues	new-values
nexceptions	n-exceptions
nextbyte	next-byte
nextnonce	next-nonce
nextseed	next-seed
nextsize	next-size
nflexible	n-flexible
ngrowing	n-growing
nindices	n-indices
nlprefix	nl-prefix
nocomment	no-comment
nocompress	no-compress
nodename	node-name
nodepath	node-path
nodeprecated	no-deprecated
nodeprecatedlist	no-deprecated-list
nodetype	node-type
nofparen	n-of-paren
noframes	n-of-rames
noindent	no-indent
noinform	no-inform
nomirror	no-mirror
nonascii	non-ascii
nonaspects	non-aspects
nonavbar	no-nav-bar
nondeterminism	nondeterminism
noninlinetags	non-inline-tags
nonnulls	non-nulls
nonpublic	non-public
nonsliecd	non-sliecd
nopackage	no-package
nopixfmt	no-pix-fmt
noprompt	no-prompt
noqualifier	no-qualifier
normalise	normalise
normalize	normalize
normalized	normalized
normalizer	normalizer
notebooks	notebooks
notequals	not-equals
notfound	not-found
notified	notified
notifier	notifier
notifiers	notifiers
notinuse	not-in-use
notrunning	not-running
novalidation	no-validation
noxembed	no-x-embed
npurecell	n-pure-cell
nrunnables	n-runnables
nsapplication	ns-application
nsessions	n-sessions
nsubtrahend	nsubtrahend
ntargets	n-targets
ntdomain	nt-domain
ntemplate	n-template
ntestright	n-test-right
ntresponse	nt-response
nueparents	nue-parents
nullname	null-name
nullpipe	null-pipe
numberofslashes	number-of-slashes
numbuffers	num-buffers
numchild	num-child
numconfigs	num-configs
numfiles	num-files
numhalfhours	num-half-hours
numnondigits	num-non-digits
numright	num-right
numroots	num-roots
numspans	num-spans
numtrans	num-trans
numtries	num-tries
nunbound	nun-bound
nwritten	n-written
obfuscated	obfuscated
obfuscators	obfuscators
objectid	object-id
objectowner	object-owner
objectref	object-ref
objectspace	object-space
objreftype	obj-ref-type
objselect	obj-select
observable	observable
occupant	occupant
occupied	occupied
occupier	occupier
occurance	occurance
occurences	occurences
occurred	occurred
occurrences	occurrences
oelement	o-element
offgraphics	off-graphics
offscreen	off-screen
offscreensize	off-screen-size
oldbytes	old-bytes
oldflags	old-flags
oldmanager	old-manager
oldpayload	old-payload
oldpbase	old-p-base
oldthumbs	old-thumbs
oldtokens	old-tokens
oldvalid	old-valid
oldvalue	old-value
oldvalues	old-values
ondblclick	on-dbl-click
onmouseout	on-mouse-out
onmouseup	on-mouse-up
ontology	ontology
oomeenabled	oome-enabled
openings	openings
operands	operands
operation	operation
operator	operator
operators	operators
opsysstring	op-sys-string
optimistic	optimistic
optimize	optimize
optional	optional
optionalfeatures	optional-features
optionnames	option-names
optiontransferselect	option-transfer-select
orderable	orderable
organization	organization
organizer	organizer
origbuttonmodel	orig-button-model
origdefault	orig-default
originalms	original-ms
originalpattern	original-pattern
originalwsdlmodel	original-wsdl-model
originhtml	origin-html
originmember	origin-member
origlength	orig-length
origmult	orig-mult
origrect	orig-rect
origstate	orig-state
orthogonalizer	orthogonalizer
osbounds	os-bounds
osfields	os-fields
othercdih	other-cdih
othergnode	other-g-node
otherkey	other-key
otherkeys	other-keys
othermode	other-mode
othermods	other-mods
otherstartc	other-start-c
otherstartl	other-start-l
othersuccessors	other-successors
othervalues	other-values
otherwise	otherwise
outerjoin	outer-join
outerscan	outer-scan
outformat	out-format
outgoings	outgoings
outliers	outliers
outovropt	out-ovr-opt
outphrase	out-phrase
outpixbuf	out-pix-buf
outputdir	output-dir
outputprops	output-props
outputter	out-putter
outqueue	out-queue
overlapped	overlapped
overridden	overridden
overrideip	override-ip
overridens	override-ns
overriders	overriders
overriding	overriding
oversize	oversize
overwrite	overwrite
ownerhref	owner-href
owneronly	owner-only
packaged	packaged
packagedoc	package-doc
packagee	packagee
packager	packager
packages	packages
packagings	packagings
packname	pack-name
padcount	pad-count
pagebook	page-book
pageheight	page-height
pagename	page-name
pagenotend	page-not-end
pairwise	pairwise
palettes	palettes
paleturquoise	pale-turquoise
palevioletred	pale-violet-red
pannotations	p-annotations
papayawhip	papaya-whip
parallelizable	parallelizable
paramcodes	param-codes
paramdtd	param-dtd
parameterdes	parameter-des
parameterize	parameterize
parameterized	parameterized
parameterleft	parameter-left
parameterlist	parameter-list
parametersleft	parameters-left
parametersright	parameters-right
paramsig	param-sig
parendepth	paren-depth
parentbound	parent-bound
parentdirname	parent-dir-name
parentgc	parent-gc
parentgl	parent-gl
parenthesized	parenthesized
parentid	parent-id
parmsfalse	parms-false
parmtypes	parm-types
parseable	parseable
parseonly	parse-only
particle	particle
particular	particular
partition	partition
partitionings	partitionings
partitions	partitions
partypes	par-types
passlabel	pass-label
patchdir	patch-dir
patchers	patchers
patching	patching
patchlevel	patch-level
patharray	path-array
pathinate	pathinate
pathnames	path-names
patriarch	patriarch
patternstok	patterns-tok
pclistener	pc-listener
pcontext	p-context
pdefault	p-default
pdestination	p-destination
pendings	pendings
pentries	p-entries
perclause	per-clause
perfomer	perfomer
permanent	permanent
permanently	permanently
permission	permission
permissive	permissive
permutation	permutation
permutations	permutations
perpectives	perpectives
persistable	persistable
persistant	persistant
persisted	persisted
persister	persister
persistor	persistor
perspectives	perspectives
pexports	p-exports
phonetics	phonetics
phpgroups	php-groups
physicalfonts	physical-fonts
picflags	pic-flags
pineapple	pineapple
pipeables	pipeables
pipeline	pipeline
pixellate	pixellate
pixlength	pix-length
pkcheckbox	pk-check-box
pkcolname	pk-col-name
pkeyenum	p-key-enum
pkglength	pkg-length
pkglisturl	pkg-list-url
pkgright	pkg-right
pkgtrans	pkg-trans
placeholder	placeholder
placeholders	placeholders
placements	placements
playable	playable
plistener	p-listener
plotpoints	plot-points
pmodules	p-modules
pmonitor	p-monitor
pointcut	point-cut
pointers	pointers
polymorphism	polymorphism
pomqnames	pom-q-names
poolable	poolable
popclass	pop-class
popularities	popularities
popularity	popularity
populatecallcount	populate-call-count
populators	populators
portcomponent	port-component
portfolio	portfolio
portlink	port-link
portlist	port-list
porttype	port-type
positioned	positioned
positioner	positioner
positions	positions
posixthread	posix-thread
possibilities	possibilities
possibility	possibility
possible	possible
possition	possition
postcode	postcode
postfixes	post-fixes
postscript	post-script
postserialize	post-serialize
potential	potential
powerdown	power-down
precalculate	precalculate
precedence	precedence
precedences	precedences
precedes	precedes
precisify	precisify
precision	precision
precompilation	pre-compilation
precompute	pre-compute
precondition	precondition
predaxis	pred-axis
predicates	predicates
predicts	predicts
preductor	preductor
preffered	preffered
prefixattr	prefix-attr
prefixing	prefixing
prefixkey	prefix-key
prefsize	pref-size
preinclude	pre-include
preinvalidate	pre-invalidate
preinvoke	pre-invoke
preloading	preloading
preparation	preparation
prepopulated	prepopulated
preprettyserialize	pre-pretty-serialize
preregister	preregister
prerequisites	prerequisites
preresolve	pre-resolve
prescreen	pre-screen
prevchar	prev-char
preverifier	preverifier
previewable	previewable
previndex	prev-index
prevmode	prev-mode
prevsave	prev-save
prevzrec	prev-z-rec
prewrite	pre-write
primaryleft	primary-left
printbutton	print-button
printconsolehelp	print-console-help
printfields	print-fields
printheader	print-header
printing	printing
printlnv	print-lnv
printout	print-out
printprefs	print-prefs
printstream	print-stream
printverbosecls	print-verbose-cls
printwelcome	print-welcome
pristine	pristine
privilege	privilege
privprof	priv-prof
privprops	priv-props
problematic	problematic
procedure	procedure
processors	processors
production	production
profilecompleter	profile-completer
profileid	profile-id
profilemode	profile-mode
programbuf	program-buf
progressclass	progress-class
progressed	progressed
progresses	progresses
prohibited	prohibited
projectchange	project-change
projectid	project-id
projectxml	project-xml
property	property
propertykey	property-key
propertyname	property-name
propertyresults	property-results
proportion	proportion
proportional	proportional
proportions	proportions
proposals	proposals
propvals	prop-vals
protection	protection
prototype	prototype
provdier	provdier
proxyport	proxy-port
prversion	pr-version
publicboolean	public-boolean
publisherror	publish-error
pushable	pushable
pushclass	push-class
pushmethod	push-method
pushregistry	push-registry
puttable	put-table
pversion	p-version
pyalignment	py-alignment
pystring	py-string
qpattern	q-pattern
qryattscr	qry-att-scr
qryattset	qry-att-set
qryattsns	qry-att-sns
qryclsimp	qry-cls-imp
qryrfrtbl	qry-rfr-tbl
qryrownbr	qry-row-nbr
qryrowset	qry-row-set
qryrowsns	qry-row-sns
qryscrorn	qry-scr-orn
quantifier	quantifier
quantities	quantities
quanttbl	quant-tbl
queryables	queryables
queryarea	query-area
question	question
quietness	quietness
radiobuttons	radio-buttons
randomizer	randomizer
rankings	rankings
raspberry	raspberry
rational	rational
rationalc	rational-c
rawindex	raw-index
rawpattern	raw-pattern
rawstore	raw-store
rcmdscombo	rcmds-combo
rcolumnname	r-column-name
rdbcmtok	rdbcm-tok
reachability	reachability
reachables	reachables
reactions	reactions
reactivator	reactivator
readlines	read-lines
readpartial	read-partial
realcommit	real-commit
realizations	realizations
reallocate	reallocate
reallydisable	really-disable
reallyquiet	really-quiet
realname	real-name
realpipe	real-pipe
realremoves	real-removes
realtheight	real-t-height
realthing	real-thing
reassign	reassign
reassociate	reassociate
reauthenticated	reauthenticated
rebalance	rebalance
recalculate	recalculate
reclaimed	reclaimed
recognized	recognized
recognizer	recognizer
recognizers	recognizers
reconcile	reconcile
reconfig	reconfig
reconfigurator	reconfigurator
reconized	reconized
reconnecting	reconnecting
recorded	recorded
recorder	recorder
recording	recording
recovered	recovered
recreate	recreate
rectangle	rectangle
recursion	recursion
recursive	recursive
recursivelly	recursivelly
recursively	recursively
recusive	recusive
recvfrom	recv-from
redefinition	redefinition
redeliver	redeliver
redeploy	redeploy
redeploying	redeploying
redirector	redirector
reductions	reductions
reenable	reenable
reentered	reentered
reexport	reexport
reexported	reexported
reexporter	reexporter
refactorings	refactorings
refbinding	ref-binding
refclasses	ref-classes
referenced	referenced
references	references
referencing	referencing
referents	referents
refhelper	ref-helper
reflfunc	ref-l-func
reformatting	reformatting
refvarleft	ref-var-left
refversion	ref-version
refversionval	ref-version-val
regenerate	regenerate
regexlen	regex-len
registered	registered
registers	registers
registrations	registrations
registries	registries
reincarnation	reincarnation
reinstall	reinstall
relation	relation
relationship	relationship
relative	relative
relocalize	relocalize
relocate	relocate
relocations	relocations
remainingcr	remaining-cr
remainingrc	remaining-rc
remotedir	remote-dir
remotefile	remote-file
removable	removable
removals	removals
removebutton	remove-button
renamings	renamings
renderables	renderables
renderers	renderers
rendezvous	rendezvous
renegotiate	renegotiate
reordable	reordable
reordering	reordering
reparent	reparent
repeatable	repeatable
repeated	repeated
repeater	repeater
repeaters	repeaters
repetition	repetition
repetitions	repetitions
replaced	replaced
replacee	replacee
replacefilters	replace-filters
replacer	replacer
replacers	replacers
replaces	replaces
replicate	replicate
replicating	replicating
replication	replication
replicator	replicator
repoload	repo-load
reporterr	report-err
reporters	reporters
reposition	reposition
repository	repository
repositoryurl	repository-url
representation	representation
represents	represents
reprinted	reprinted
republish	republish
reqattrin	req-attr-in
requeried	requeried
requestactive	request-active
requirements	requirements
resbundle	res-bundle
resconverter	res-converter
reservation	reservation
reserved	reserved
reserves	reserves
resetbuffer	reset-buffer
resettable	reset-table
resfilename	res-file-name
resgroup	res-group
resizing	resizing
resolutions	resolutions
resolvable	resolvable
resolvebindings	resolve-bindings
resolveclasspath	resolve-class-path
resolveclasspathhelper	resolve-class-path-helper
resolvedependencies	resolve-dependencies
resolvemode	resolve-mode
resouces	resouces
resourcebundlenodes	resource-bundle-nodes
response	response
restarted	restarted
restarter	restarter
restoreable	restoreable
restored	restored
restoring	restoring
restrict	restrict
restricted	restricted
restriction	restriction
restrictors	restrictors
restricts	restricts
restright	rest-right
resultset	result-set
resultsets	result-sets
resursively	resursively
resymbolize	resymbolize
retargeted	retargeted
retattrs	ret-attrs
retention	retention
retrieval	retrieval
retrieve	retrieve
retrieved	retrieved
retriever	retriever
returndes	return-des
reversible	reversible
reverting	reverting
reviewers	reviewers
revocation	revocation
rewriting	rewriting
rewritten	rewritten
rfunction	r-function
rhsright	rhs-right
rightbracket	right-bracket
rightright	right-right
rigidity	rigidity
rlistener	r-listener
rlocation	r-location
rnstroke	rn-stroke
rolename	role-name
rootclass	root-class
roundfilter	round-filter
roundtrip	round-trip
rowbuffer	row-buffer
rowcolor	row-color
rowcount	row-count
rowincyerr	row-inc-y-err
rowmodel	row-model
rowspans	row-spans
rowstatus	row-status
rowstring	row-string
royalblue	royal-blue
rpatterns	r-patterns
rsasigfield	rs-asig-field
rsconcur	rs-concur
rsession	r-session
rsoffsets	rs-offsets
rtfversion	rtf-version
rthandler	rt-handler
rulename	rule-name
runmxbean	run-mx-bean
runnables	runnables
runserver	run-server
runtimeexception	runtime-exception
runtimes	runtimes
runwithibmjvm	run-with-ibm-jvm
safepoints	safe-points
sancestor	s-ancestor
sanitized	sanitized
saturate	saturate
saturday	saturday
savedefaultsbutton	save-defaults-button
savedout	saved-out
saxparser	sax-parser
scalable	scalable
scalagroup	scala-group
scalefactor	scale-factor
scanline	scan-line
scanlines	scan-lines
scannedprojects	scanned-projects
scanners	scanners
scanning	scanning
scanrsets	scan-r-sets
scansize	scan-size
scheduled	scheduled
scheduler	scheduler
scheduling	scheduling
schemaname	schema-name
schemapointerindex	schema-pointer-index
scorelast	score-last
scorelength	scorelength
scrambled	scrambled
scrambler	scrambler
scrapeannouncepercentage	scrape-announce-percentage
scrapfile	scrap-file
scriptable	scriptable
scripting	scripting
scrollable	scrollable
scrollbar	scroll-bar
scrolling	scrolling
scurrent	s-current
searched	searched
searcher	searcher
searches	searches
searchpaths	search-paths
searchstr	search-str
searchview	search-view
secchkcd	secchkcd
secondaries	secondaries
secondes	secondes
secondmask	second-mask
seconduscore	second-u-score
secpropag	sec-propag
seenplusminus	seen-plus-minus
seentitle	seen-title
segmentexist	segment-exist
selectable	selectable
selectables	selectables
selectedrows	selected-rows
selectionlistener	selection-listener
selectivity	selectivity
selenium	selenium
semicolons	semicolons
sensitive	sensitive
sentences	sentences
separate	separate
seperator	seperator
sequencer	sequencer
sequences	sequences
sequential	sequential
serializing	serializing
servermarks	server-marks
serverresources	server-resources
serviceprops	service-props
servletout	servlet-out
servlets	servlets
servname	serv-name
sessions	sessions
setinsertionpoint	set-insertion-point
setmethod	set-method
setmodules	set-modules
setparent	set-parent
setpwent	set-pw-ent
setrecursionlimit	set-recursion-limit
setreqflag	set-req-flag
setrlimit	set-r-limit
setstate	set-state
severity	severity
sfeature	s-feature
shadowed	shadowed
shadowing	shadowing
sharability	sharability
shortcircuit	short-circuit
shortdays	short-days
shortnames	short-names
shortopts	short-opts
shortval	short-val
shortxorarr	short-xor-arr
shouldsave	should-save
showexception	show-exception
showproperties	show-properties
showresults	show-results
showversion	show-version
shrinkable	shrinkable
shrinkage	shrinkage
shrinking	shrinking
shutdownstr	shut-down-str
shutdownurl	shut-down-url
signaler	signaler
signatures	signatures
signaturevisitor	signature-visitor
signerinfo	signer-info
sigupdate	sig-update
silently	silently
simulate	simulate
simulationmode	simulation-mode
skipfirst	skip-first
skipping	skipping
slateblue	slate-blue
slicelength	slice-length
slotstate	slot-state
slowness	slowness
smethods	s-methods
smtpport	smtp-port
smtptext	smtp-text
snapping	snapping
snapshots	snapshots
soaproles	soap-roles
socketnsl	socket-nsl
solutions	solutions
something	something
sortedreports	sorted-reports
sortpointer	sort-pointer
soughtexclude	sought-exclude
soundbank	sound-bank
sourceclasspath	source-class-path
sourceresources	source-resources
spacenasty	space-nasty
spanstart	span-start
specialization	specialization
specials	specials
specific	specific
specifications	specifications
specifics	specifics
specified	specified
specifier	specifier
spectator	spectator
spectypedecls	spec-type-decls
specversion	spec-version
spkidata	spki-data
splitfields	split-fields
splitmessages	split-messages
splitpos	split-pos
splitrow	split-row
splitted	splitted
splitter	splitter
splitters	splitters
sportlabel	sport-label
sprohome	spro-home
sqldreturn	sqld-return
sqldschema	sqld-schema
sqlerrproc	sql-err-proc
sqlunnamed	sql-unnamed
sqlxbasename	sqlx-base-name
sqlxcorname	sqlx-cor-name
sqlxname	sqlx-name
sqlxrdbnam	sqlx-rdb-nam
srcbegin	src-begin
srcconverter	src-converter
srcdoctype	src-doc-type
srcelements	src-elements
srcentity	src-entity
srcfield	src-field
srcindex	src-index
srcksfile	src-ks-file
srcnotation	src-notation
sresource	s-resource
srvrlslv	srvrlslv
ssecurity	s-security
ssverbose	ss-verbose
stacktop	stack-top
standard	standard
standardize	standardize
standins	stand-ins
starpati	star-pati
starstri	star-stri
startcolumn	start-column
starteamrootfolder	star-team-root-folder
startegy	start-egy
startelement	start-element
startlocline	start-loc-line
startmask	start-mask
startminute	start-minute
startproto	start-proto
startright	start-right
startuser	start-user
starving	starving
stateless	stateless
statemachines	state-machines
statementsleft	statements-left
statename	state-name
statfilt	stat-filt
staticof	static-of
staticvars	static-vars
statistic	statistic
statusbar	status-bar
statustype	status-type
stdprompt	std-prompt
stdstyle	std-style
stdtextcolor	std-text-color
stepleft	step-left
stepping	stepping
stepright	step-right
stgmedium	stg-medium
stillinterested	still-interested
stimulus	stimulus
stoppers	stoppers
stopping	stopping
stoptime	stop-time
storable	storable
storages	storages
storepassword	store-password
strategies	strategies
streamer	streamer
strength	strength
strengths	strengths
strftime	str-ftime
strictargs	strict-args
strictassign	strict-assign
strictprops	strict-props
strictsignal	strict-signal
stringfilter	string-filter
stringright	string-right
stringwidth	string-width
strokewidth	stroke-width
strptime	strp-time
structure	structure
stubname	stub-name
stylesheets	style-sheets
subalias	sub-alias
subcheckable	sub-checkable
subcodes	sub-codes
subcolumn	sub-column
subcomps	sub-comps
subcontainers	sub-containers
subcontract	subcontract
subcriteria	sub-criteria
subcurve	sub-curve
subdirectories	subdirectories
subelement	sub-element
subentries	sub-entries
subexpression	sub-expression
subfault	sub-fault
subfaults	sub-faults
subfolders	sub-folders
subgroups	subgroups
subhandler	sub-handler
subinterfaces	subinterfaces
subklass	sub-klass
sublayout	sub-layout
submenus	sub-menus
submissions	submissions
submitted	submitted
submitter	submitter
subnormal	subnormal
suboptions	sub-options
subpanel	sub-panel
subpanels	sub-panels
subparent	sub-parent
subparse	sub-parse
subpaths	sub-paths
subpopup	sub-popup
subprojects	subprojects
subquery	sub-query
subrange	sub-range
subresult	sub-result
subroutine	subroutine
subroutines	subroutines
subscribed	subscribed
subscriber	subscriber
subsettable	sub-settable
subshell	sub-shell
substate	sub-state
substoken	subs-token
substring	substring
subterms	sub-terms
subtitle	subtitle
subtitutions	subtitutions
subtopic	subtopic
subtopics	subtopics
subtypes	subtypes
subvalues	sub-values
subvector	sub-vector
subversion	subversion
succeeded	succeeded
succesful	succesful
suggested	suggested
suggestion	suggestion
suitable	suitable
summaries	summaries
summarize	summarize
summarized	summarized
sunpurple	sun-purple
supercomposite	super-composite
superfield	super-field
superinterfaces	super-interfaces
superintfs	super-intfs
supernames	super-names
superquery	super-query
superset	super-set
supersig	super-sig
supertask	super-task
supplemental	supplemental
suppliers	suppliers
surrogate	surrogate
surround	surround
surrugate	surrugate
svnrevision	svn-revision
swapcase	swap-case
symbolize	symbolize
symidleft	sy-mid-left
symidright	sy-mid-right
symright	sym-right
syncmins	sync-mins
syncptmgr	sync-pt-mgr
synthesizer	synthesizer
sysprops	sys-props
tablecolcount	table-col-count
tablecount	table-count
tableidx	table-idx
tableize	tableize
tablename	table-name
tableviewer	table-viewer
tagcount	tag-count
tagelement	tag-element
targetcomponent	target-component
targeted	targeted
targeter	targeter
targetid	target-id
targetmember	target-member
targetwidth	target-width
taskdesc	task-desc
tasktext	task-text
tblswitch	tbl-switch
tcgetattr	tc-get-attr
tcheight	tc-height
tchildren	tc-hildren
tdataset	t-data-set
tdvaligns	tdv-aligns
teardown	tear-down
telement	t-element
temparguments	temp-arguments
tempbyte	temp-byte
tempctxt	temp-ctxt
templates	templates
tenpower	ten-power
terabytes	terabytes
terminals	terminals
terminate	terminate
termpath	term-path
testfolder	test-folder
testlang	test-lang
testname	test-name
testnames	test-names
testtype	test-type
textfield	text-field
textpane	text-pane
textpipe	text-pipe
textwidth	text-width
theentry	the-entry
theexpression	the-expression
theletters	the-letters
theseurls	these-urls
thevalue	the-value
thiscoef	this-coef
thisconfig	this-config
thisparams	this-params
thisprim	this-prim
threaded	threaded
threadinfo	thread-info
threeway	three-way
threhsold	threhsold
threshhold	threshhold
throughput	throughput
thrownbuf	thrown-buf
tickercolor	ticker-color
tickerlen	ticker-len
tickheight	tick-height
tiebreaker	tiebreaker
tightener	tightener
timedelta	time-delta
timeframe	time-frame
timerevent	timer-event
timeslice	time-slice
timestamp	time-stamp
timestart	time-start
timestop	time-stop
timezone	timezone
titleize	titleize
tlistleft	t-list-left
todisable	to-disable
todostring	todo-string
toenable	to-enable
tokcount	tok-count
tokenize	tokenize
tokenname	token-name
tokennizer	tokennizer
tokenright	token-right
tokenstart	token-start
tokentree	token-tree
toolbarpanel	tool-bar-panel
tooltipkey	tool-tip-key
tooltiptext	tool-tip-text
toplevel	top-level
topparent	top-parent
torrentview	torrent-view
tostring	to-string
totallen	total-len
totalmem	total-mem
totalscore	total-score
totalstart	total-start
touchpoint	touch-point
tounicode	to-unicode
tpattern	t-pattern
tpbounds	tp-bounds
traceback	trace-back
tracefunc	trace-func
trackable	trackable
trackerclient	tracker-client
trackerid	tracker-id
trackers	trackers
tracking	tracking
trainrecog	train-recog
transact	transact
transaction	transaction
transactional	transactional
transfer	transfer
transferables	transferables
transfers	transfers
transform	transform
transformable	transformable
transformations	transformations
transfrom	transfrom
transitions	transitions
translated	translated
translatex	translate-x
translatey	translate-y
translations	translations
translator	translator
transmitter	transmitter
transmitters	transmitters
transpositions	transpositions
trashcan	trash-can
trashhold	trash-hold
trayname	tray-name
treeitem	tree-item
treepath	tree-path
treetable	tree-table
treeviewer	tree-viewer
treewalker	tree-walker
treshhold	treshhold
triangle	triangle
trimmable	trimmable
trimpath	trim-path
triplets	triplets
trstring	tr-string
truncate	truncate
truncated	truncated
truncator	truncator
truncbox	trunc-box
tstampff	t-stamp-ff
tstripped	t-stripped
tuplizers	tuplizers
tvmargin	tv-margin
typebinding	type-binding
typebound	type-bound
typebuff	type-buff
typecheck	type-check
typeconst	type-const
typecounter	type-counter
typedval	typed-val
typefile	type-file
typenode	type-node
typeparms	type-parms
typeright	type-right
ucharppty	u-char-ppty
uichange	ui-change
uidcompare	uid-compare
uistring	ui-string
ultimate	ultimate
unadvertise	unadvertise
unallocated	unallocated
unambiguous	unambiguous
unblocked	unblocked
unboxify	unboxify
unboxing	unboxing
unbuffer	unbuffer
uncacheable	uncacheable
unclosed	unclosed
uncomment	uncomment
uncommitted	uncommitted
uncomparable	uncomparable
unconfirmed	unconfirmed
unconsumed	unconsumed
unconverted	unconverted
undeclare	undeclare
undeploy	undeploy
undeploying	undeploying
underflow	underflow
underline	underline
underlying	underlying
underneath	underneath
undoable	undoable
unencoded	unencoded
unenlisted	unenlisted
unexploded	unexploded
unfetched	unfetched
unfinalized	unfinalized
unicodes	unicodes
uninstall	uninstall
uninterested	uninterested
unintern	unintern
uniquecheckbox	unique-check-box
uniqueid	unique-id
uniquifier	uniquifier
unitilialize	unitilialize
unitname	unit-name
unittestbg	unit-test-bg
universal	universal
universe	universe
unixaddr	unix-addr
unlesstest	unless-test
unmarshaller	unmarshaller
unmodified	unmodified
unpacking	unpacking
unparsable	unparsable
unpickler	unpickler
unproxied	unproxied
unqualified	unqualified
unrecognized	unrecognized
unreflect	unreflect
unremoved	unremoved
unresolved	unresolved
unrestricted	unrestricted
unscaled	unscaled
unscheduled	unscheduled
unsequenced	unsequenced
unsolicited	unsolicited
unstarted	unstarted
unstripped	unstripped
unswallowed	unswallowed
unusable	unusable
unusedlabels	unused-labels
updating	updating
updownselect	up-down-select
upgradejarpath	upgrade-jar-path
upgradetest	upgrade-test
upstream	upstream
uriresolver	uri-resolver
urlprefix	url-prefix
usecaches	use-caches
usedkeys	used-keys
useexistingdb	use-existing-db
userdirective	user-directive
userhandle	user-handle
userlabel	user-label
userlocale	user-locale
usertext	user-text
useslope	use-slope
uuidstring	uuid-string
validate	validate
validateable	validateable
validity	validity
valignment	v-alignment
valstring	val-string
valueleft	value-left
valuelen	value-len
valueloc	value-loc
valuemask	value-mask
valueright	value-right
varbinds	var-binds
variance	variance
variation	variation
varstack	var-stack
vbproject	vb-project
vcsannotations	vcs-annotations
vecclone	vec-clone
vehandle	ve-handle
verboselevel	verbose-level
verboten	verboten
verification	verification
verisign	verisign
vertexes	vertexes
vertically	vertically
verylongname	very-long-name
violations	violations
violator	violator
virginal	virginal
visibility	visibility
visitable	visitable
visitors	visitors
visualid	visual-id
visualnum	visual-num
vmproxyhash	vm-proxy-hash
vocabulary	vocabulary
voidreturn	void-return
vscrollbar	v-scroll-bar
vsignature	v-signature
vsigners	v-signers
vsplitter	v-splitter
wackohacko	wacko-hacko
waitflag	wait-flag
warehouse	warehouse
watchpoint	watch-point
watermelon	watermelon
waypoint	waypoint
wbaseline	w-baseline
wcswidth	wcs-width
webproject	web-project
webseeds	web-seeds
webservices	web-services
wednesday	wednesday
weekdays	weekdays
whatelse	what-else
whenspsd	when-spsd
wherefrom	wherefrom
whichargument	which-argument
whichmodule	which-module
whichptr	which-ptr
whileloop	while-loop
whitelist	white-list
whitesmoke	white-smoke
wildcard	wildcard
wildchar	wild-char
withdraw	withdraw
withsubs	with-subs
wkstarthr	wk-start-hr
wordcutoff	word-cut-off
wordlist	word-list
wordsbreak	words-break
wordshift	word-shift
workingset	working-set
workspaces	workspaces
worstscore	worst-score
worstspread	worst-spread
writebuf	write-buf
writecount	write-count
writefile	write-file
writenamespace	write-namespace
writeover	write-over
writerow	write-row
wsbinding	ws-binding
wsdlfactory	wsdl-factory
wsimport	ws-import
wsplugins	ws-plugins
xaretval	xa-ret-val
xcompare	x-compare
xfactory	x-factory
xmessage	x-message
xmlcharrefreplace	xml-char-ref-replace
xmlreporter	xml-reporter
xmlsource	xml-source
xmlvalidation	xml-validation
xoperations	x-operations
xorpixelmod	xor-pixel-mod
xoverlap	x-overlap
xpointerschema	x-pointer-schema
xproperty	x-property
xstringfactory	x-string-factory
xtextpipe	x-text-pipe
xurlencoded	x-url-encoded
xvisualid	x-visual-id
xyitemrenderer	xy-item-renderer
xylineandshaperenderer	xy-line-and-shape-renderer
xyzvalue	xyz-value
yesvotes	yes-votes
yposition	y-position
ythickness	y-thickness
yylength	yy-length
zipfileset	zip-file-set
zonefile	zone-file
zoneoffset	zone-offset
zoomable	zoomable
